Player,Pos,Age,Tm,G,GS,MP,FG,FGA,FG%,3P,3PA,3P%,2P,2PA,2P%,eFG%,FT,FTA,FT%,ORB,DRB,TRB,AST,STL,BLK,TOV,PF,PTS
Steven Adams,C,26,OKC,18,18,485,86,139,.619,0,1,.000,86,138,.623,.619,27,53,.509,54,110,164,50,10,21,26,36,199
Bam Adebayo,C,22,MIA,22,22,720,117,205,.571,1,6,.167,116,199,.583,.573,80,123,.650,53,176,229,88,29,27,61,55,315
LaMarcus Aldridge,C,34,SAS,21,21,691,161,314,.513,12,33,.364,149,281,.530,.532,62,74,.838,44,103,147,51,13,37,34,46,396
Nickeil Alexander-Walker,SG,21,NOP,19,0,274,45,139,.324,23,73,.315,22,66,.333,.406,11,16,.688,4,41,45,39,7,2,23,26,124
Grayson Allen,SG,24,MEM,12,0,234,32,84,.381,12,39,.308,20,45,.444,.452,15,17,.882,2,34,36,19,5,0,13,21,91
Jarrett Allen,C,21,BRK,22,19,580,105,156,.673,0,1,.000,105,155,.677,.673,55,92,.598,79,153,232,25,17,30,26,57,265
Kadeem Allen,SG,27,NYK,1,0,16,3,6,.500,3,4,.750,0,2,.000,.750,0,0,NA,0,0,0,2,1,0,1,1,9
Al-Farouq Aminu,PF,29,ORL,18,2,380,25,86,.291,9,36,.250,16,50,.320,.343,19,29,.655,24,63,87,21,18,8,17,27,78
Kyle Anderson,PF,26,MEM,17,0,348,47,93,.505,4,16,.250,43,77,.558,.527,16,28,.571,16,59,75,44,12,12,15,29,114
Ryan Anderson,PF,31,HOU,2,0,14,2,7,.286,1,5,.200,1,2,.500,.357,0,0,NA,0,7,7,2,1,0,1,1,5
Giannis Antetokounmpo,PF,25,MIL,23,23,723,263,466,.564,36,114,.316,227,352,.645,.603,147,248,.593,61,241,302,125,30,30,89,74,709
Kostas Antetokounmpo,PF,22,LAL,2,0,3,0,0,NA,0,0,NA,0,0,NA,NA,0,0,NA,0,1,1,0,0,0,0,0,0
Thanasis Antetokounmpo,SF,27,MIL,4,0,25,6,10,.600,0,0,NA,6,10,.600,.600,2,4,.500,3,0,3,4,0,0,2,3,14
Carmelo Anthony,PF,35,POR,9,9,282,56,129,.434,13,34,.382,43,95,.453,.484,25,29,.862,9,41,50,15,8,2,19,30,150
OG Anunoby,SF,22,TOR,20,20,586,86,165,.521,32,75,.427,54,90,.600,.618,13,25,.520,18,90,108,36,24,17,23,49,217
Ryan Arcidiacono,PG,25,CHI,23,0,383,32,84,.381,22,53,.415,10,31,.323,.512,15,20,.750,13,27,40,40,12,2,17,47,101
Trevor Ariza,SF,34,SAC,14,0,304,22,61,.361,17,47,.362,5,14,.357,.500,7,9,.778,6,45,51,12,13,2,11,21,68
D.J. Augustin,PG,32,ORL,22,5,565,69,183,.377,23,74,.311,46,109,.422,.440,50,57,.877,11,44,55,104,16,0,32,24,211
Deandre Ayton,C,21,PHO,1,1,33,9,14,.643,0,0,NA,9,14,.643,.643,0,0,NA,3,8,11,0,1,4,0,2,18
Dwayne Bacon,SG,24,CHO,18,10,358,47,147,.320,10,42,.238,37,105,.352,.354,19,28,.679,8,39,47,21,14,2,19,31,123
Marvin Bagley,PF,20,SAC,1,1,28,6,16,.375,0,0,NA,6,16,.375,.375,2,4,.500,4,6,10,0,1,1,1,1,14
Lonzo Ball,PG,22,NOP,15,12,431,60,160,.375,34,100,.340,26,60,.433,.481,10,14,.714,12,53,65,86,17,6,41,30,164
Mo Bamba,C,21,ORL,20,0,312,44,105,.419,15,39,.385,29,66,.439,.490,5,10,.500,27,80,107,9,6,28,26,44,108
J.J. Barea,PG,35,DAL,5,0,66,18,39,.462,10,15,.667,8,24,.333,.590,2,2,1.000,1,8,9,12,2,1,4,2,48
Harrison Barnes,PF,27,SAC,21,21,745,118,246,.480,29,78,.372,89,168,.530,.539,81,101,.802,23,84,107,46,19,4,31,27,346
RJ Barrett,SG,19,NYK,22,22,707,117,296,.395,22,71,.310,95,225,.422,.432,59,111,.532,26,91,117,72,30,11,54,55,315
Will Barton,SF,29,DEN,18,18,583,98,219,.447,34,84,.405,64,135,.474,.525,30,41,.732,29,92,121,60,17,7,24,40,260
Keita Bates-Diop,SF,24,MIN,10,0,190,30,58,.517,15,32,.469,15,26,.577,.647,5,8,.625,5,22,27,4,4,4,5,11,80
Nicolas Batum,SF,31,CHO,13,0,293,16,44,.364,9,33,.273,7,11,.636,.466,5,5,1.000,15,42,57,42,11,7,19,22,46
Aron Baynes,C,33,PHO,13,12,312,71,126,.563,25,57,.439,46,69,.667,.663,24,34,.706,19,55,74,38,4,9,14,51,191
Kent Bazemore,SF,30,POR,23,2,516,59,169,.349,28,81,.346,31,88,.352,.432,34,43,.791,9,89,98,38,21,17,33,68,180
Darius Bazley,PF,19,OKC,21,0,352,32,77,.416,14,38,.368,18,39,.462,.506,9,16,.563,7,67,74,12,7,9,16,19,87
Bradley Beal,SG,26,WAS,21,21,777,207,450,.460,57,164,.348,150,286,.524,.523,124,150,.827,22,76,98,148,21,5,74,55,595
Malik Beasley,SG,23,DEN,16,0,255,40,105,.381,21,50,.420,19,55,.345,.481,6,7,.857,4,17,21,16,8,2,16,18,107
Marco Belinelli,SG,33,SAS,21,0,340,39,124,.315,21,63,.333,18,61,.295,.399,15,21,.714,1,34,35,32,5,0,9,17,114
Jordan Bell,C,25,MIN,11,0,100,16,28,.571,0,4,.000,16,24,.667,.571,11,19,.579,11,27,38,8,0,4,13,9,43
DeAndre' Bembry,SG,25,ATL,22,4,580,69,142,.486,9,35,.257,60,107,.561,.518,18,37,.486,24,79,103,63,33,11,34,50,165
Dragan Bender,SF,22,MIL,3,0,29,6,8,.750,2,4,.500,4,4,1.000,.875,1,1,1.000,0,2,2,3,0,2,1,6,15
Dāvis Bertāns,PF,27,WAS,21,1,607,102,222,.459,78,174,.448,24,48,.500,.635,21,24,.875,19,77,96,33,13,13,14,52,303
Patrick Beverley,PG,31,LAC,21,21,624,57,152,.375,27,91,.297,30,61,.492,.464,14,23,.609,30,98,128,66,31,12,31,80,155
Khem Birch,C,27,ORL,13,8,291,22,44,.500,0,1,.000,22,43,.512,.500,13,26,.500,29,46,75,14,7,9,9,35,57
Goga Bitadze,C,20,IND,17,2,216,26,57,.456,4,14,.286,22,43,.512,.491,14,19,.737,16,36,52,14,1,19,10,33,70
Bismack Biyombo,C,27,CHO,22,7,366,63,110,.573,0,0,NA,63,110,.573,.573,36,65,.554,35,60,95,19,6,17,14,43,162
Nemanja Bjelica,PF,31,SAC,21,20,545,86,187,.460,36,87,.414,50,100,.500,.556,14,15,.933,43,101,144,54,20,12,37,63,222
Eric Bledsoe,PG,30,MIL,23,23,618,131,280,.468,27,84,.321,104,196,.531,.516,55,70,.786,20,93,113,129,19,10,51,56,344
Bogdan Bogdanović,SG,27,SAC,19,0,517,97,241,.402,51,136,.375,46,105,.438,.508,30,42,.714,4,49,53,85,26,2,35,34,275
Bojan Bogdanović,SF,30,UTA,22,22,729,156,334,.467,69,152,.454,87,182,.478,.570,79,89,.888,16,81,97,46,16,4,61,43,460
Jonah Bolden,PF,24,PHI,2,0,5,1,1,1.000,0,0,NA,1,1,1.000,1.000,0,2,.000,0,0,0,0,1,0,1,0,2
Jordan Bone,PG,22,DET,3,0,6,2,5,.400,0,1,.000,2,4,.500,.400,0,0,NA,0,0,0,0,0,0,2,2,4
Isaac Bonga,SF,20,WAS,16,10,251,25,46,.543,4,11,.364,21,35,.600,.587,10,13,.769,11,32,43,22,11,3,9,33,64
Devin Booker,SG,23,PHO,22,22,786,196,383,.512,51,123,.415,145,260,.558,.578,117,128,.914,13,72,85,137,14,7,87,70,560
Chris Boucher,PF,27,TOR,18,0,222,36,81,.444,8,28,.286,28,53,.528,.494,20,29,.690,38,42,80,10,7,15,7,26,100
Brian Bowen,SG,21,IND,3,0,10,1,4,.250,0,1,.000,1,3,.333,.250,0,0,NA,0,1,1,0,0,1,0,0,2
Ky Bowman,PG,22,GSW,24,6,564,84,185,.454,25,61,.410,59,124,.476,.522,19,20,.950,13,52,65,69,23,3,31,50,212
Avery Bradley,SG,29,LAL,10,10,274,41,84,.488,8,28,.286,33,56,.589,.536,6,8,.750,7,25,32,18,10,1,11,26,96
Tony Bradley,C,22,UTA,17,2,161,30,50,.600,0,0,NA,30,50,.600,.600,11,16,.688,24,36,60,4,2,8,8,28,71
Jarrell Brantley,PF,23,UTA,2,0,9,0,0,NA,0,0,NA,0,0,NA,NA,0,0,NA,0,4,4,1,0,2,1,1,0
Ignas Brazdeikis,SF,21,NYK,6,0,42,5,19,.263,1,7,.143,4,12,.333,.289,3,4,.750,2,2,4,1,0,1,2,2,14
Mikal Bridges,SF,23,PHO,22,0,453,58,115,.504,11,37,.297,47,78,.603,.552,31,40,.775,17,60,77,22,29,6,17,40,158
Miles Bridges,SF,21,CHO,24,24,727,117,261,.448,38,104,.365,79,157,.503,.521,27,35,.771,34,94,128,44,11,18,39,49,299
Oshae Brissett,SF,21,TOR,4,0,17,1,3,.333,1,1,1.000,0,2,.000,.500,0,0,NA,0,1,1,1,1,0,1,0,3
Ryan Broekhoff,SG,29,DAL,4,0,25,4,8,.500,4,5,.800,0,3,.000,.750,0,0,NA,0,5,5,3,1,0,1,1,12
Malcolm Brogdon,PG,27,IND,19,19,605,132,279,.473,28,81,.346,104,198,.525,.523,69,74,.932,12,81,93,147,17,4,55,39,361
Dillon Brooks,SG,24,MEM,22,22,601,105,268,.392,36,100,.360,69,168,.411,.459,42,53,.792,24,53,77,43,23,8,27,84,288
Bruce Brown,SG,23,DET,23,19,606,68,159,.428,13,37,.351,55,122,.451,.469,20,37,.541,18,78,96,84,21,12,41,63,169
Charlie Brown,SG,22,ATL,4,0,16,1,3,.333,1,1,1.000,0,2,.000,.500,4,4,1.000,2,1,3,0,0,1,0,0,7
Jaylen Brown,SF,23,BOS,18,18,602,135,272,.496,37,96,.385,98,176,.557,.564,53,73,.726,20,105,125,35,21,5,28,56,360
Moses Brown,C,20,POR,4,0,15,3,7,.429,0,0,NA,3,7,.429,.429,2,4,.500,2,7,9,0,1,0,1,4,8
Sterling Brown,SF,24,MIL,16,0,264,32,76,.421,16,41,.390,16,35,.457,.526,10,15,.667,11,65,76,23,10,2,16,22,90
Troy Brown,SG,20,WAS,18,11,379,51,117,.436,7,31,.226,44,86,.512,.466,13,17,.765,26,65,91,36,23,3,17,26,122
Jalen Brunson,PG,23,DAL,22,3,356,68,135,.504,14,43,.326,54,92,.587,.556,22,31,.710,13,41,54,59,11,0,20,26,172
Thomas Bryant,C,22,WAS,18,18,511,101,184,.549,10,35,.286,91,149,.611,.576,39,53,.736,42,111,153,48,8,18,24,44,251
Trey Burke,PG,27,PHI,9,0,152,25,58,.431,6,16,.375,19,42,.452,.483,8,11,.727,6,7,13,31,7,1,4,7,64
Alec Burks,SG,28,GSW,21,10,613,106,253,.419,30,86,.349,76,167,.455,.478,72,82,.878,13,79,92,59,21,6,29,45,314
Deonte Burton,SG,26,OKC,12,0,101,13,33,.394,5,17,.294,8,16,.500,.470,3,4,.750,3,18,21,4,1,1,4,11,34
Jimmy Butler,SF,30,MIA,18,18,616,108,243,.444,20,61,.328,88,182,.484,.486,133,157,.847,38,75,113,122,41,14,46,23,369
Bruno Caboclo,SF,24,MEM,14,0,153,24,57,.421,4,20,.200,20,37,.541,.456,2,3,.667,14,20,34,8,7,11,7,17,54
Kentavious Caldwell-Pope,SG,26,LAL,23,13,548,69,153,.451,26,67,.388,43,86,.500,.536,18,22,.818,11,38,49,37,18,4,19,39,182
Vlatko Čančar,SF,22,DEN,1,0,2,0,0,NA,0,0,NA,0,0,NA,NA,0,0,NA,0,0,0,0,0,0,0,0,0
Clint Capela,C,25,HOU,18,18,583,117,183,.639,0,0,NA,117,183,.639,.639,25,54,.463,76,188,264,19,16,35,32,54,259
DeMarre Carroll,SF,33,SAS,11,0,120,7,25,.280,3,12,.250,4,13,.308,.340,10,14,.714,7,22,29,10,2,2,9,17,27
Jevon Carter,PG,24,PHO,15,2,224,22,55,.400,14,34,.412,8,21,.381,.527,4,4,1.000,3,24,27,28,13,5,15,24,62
Vince Carter,SF,43,ATL,17,0,254,31,91,.341,15,61,.246,16,30,.533,.423,6,8,.750,3,30,33,12,6,5,10,29,83
Wendell Carter,C,20,CHI,23,23,684,110,195,.564,2,15,.133,108,180,.600,.569,62,89,.697,84,145,229,21,17,20,36,92,284
Michael Carter-Williams,SG,28,ORL,12,0,181,17,54,.315,3,19,.158,14,35,.400,.343,19,23,.826,14,26,40,21,10,6,12,19,56
Alex Caruso,PG,25,LAL,21,0,424,42,96,.438,14,43,.326,28,53,.528,.510,11,16,.688,3,38,41,40,22,7,23,35,109
Willie Cauley-Stein,C,26,GSW,21,20,468,72,131,.550,0,0,NA,72,131,.550,.550,16,25,.640,31,105,136,33,22,25,20,61,160
Tyson Chandler,C,37,HOU,18,4,163,13,17,.765,0,0,NA,13,17,.765,.765,5,9,.556,19,30,49,6,5,7,6,24,31
Zylan Cheatham,SF,24,NOP,2,0,20,1,4,.250,0,1,.000,1,3,.333,.250,0,0,NA,0,3,3,1,0,0,1,3,2
Chris Chiozza,PG,24,WAS,7,0,75,3,17,.176,2,4,.500,1,13,.077,.235,0,0,NA,0,7,7,18,5,2,6,8,8
Marquese Chriss,PF,22,GSW,23,1,412,59,123,.480,4,18,.222,55,105,.524,.496,43,50,.860,31,76,107,46,17,22,35,46,165
Gary Clark,PF,25,HOU,7,0,72,8,22,.364,5,18,.278,3,4,.750,.477,0,0,NA,6,11,17,5,1,1,1,8,21
Brandon Clarke,PF,23,MEM,18,2,381,92,146,.630,10,22,.455,82,124,.661,.664,19,23,.826,24,82,106,23,9,17,19,31,213
Jordan Clarkson,SG,27,CLE,22,0,485,97,236,.411,38,110,.345,59,126,.468,.492,65,73,.890,14,34,48,53,11,6,29,25,297
Nicolas Claxton,PF,20,BRK,9,0,119,11,21,.524,0,5,.000,11,16,.688,.524,5,12,.417,8,14,22,11,1,5,6,10,27
Chris Clemons,SG,22,HOU,15,0,131,24,58,.414,18,46,.391,6,12,.500,.569,3,4,.750,2,8,10,6,3,2,6,14,69
John Collins,PF,22,ATL,5,5,161,32,61,.525,9,19,.474,23,42,.548,.598,12,17,.706,10,34,44,8,5,10,7,17,85
Zach Collins,PF,22,POR,3,3,86,9,19,.474,3,7,.429,6,12,.500,.553,6,6,1.000,4,8,12,6,0,2,6,11,27
Mike Conley,PG,32,UTA,21,21,628,97,263,.369,40,107,.374,57,156,.365,.445,58,73,.795,16,57,73,96,15,4,44,45,292
Pat Connaughton,SG,27,MIL,21,0,381,47,94,.500,18,52,.346,29,42,.690,.596,13,17,.765,10,75,85,39,6,11,13,22,125
Quinn Cook,PG,26,LAL,19,0,257,41,95,.432,12,34,.353,29,61,.475,.495,4,5,.800,4,19,23,29,6,1,15,11,98
Tyler Cook,PF,22,CLE,6,0,17,5,6,.833,0,0,NA,5,6,.833,.833,2,2,1.000,3,2,5,0,1,0,1,1,12
Robert Covington,PF,29,MIN,20,20,557,87,189,.460,42,114,.368,45,75,.600,.571,39,44,.886,16,94,110,24,26,18,31,61,255
Allen Crabbe,SG,27,ATL,10,1,189,20,54,.370,8,33,.242,12,21,.571,.444,5,7,.714,5,22,27,9,5,2,4,7,53
Torrey Craig,SF,29,DEN,14,2,192,14,41,.341,4,20,.200,10,21,.476,.390,4,9,.444,9,26,35,15,5,11,5,27,36
Jae Crowder,SF,29,MEM,22,22,683,79,201,.393,48,146,.329,31,55,.564,.512,34,46,.739,16,112,128,61,20,8,31,45,240
Jarrett Culver,SG,20,MIN,21,11,505,76,206,.369,22,85,.259,54,121,.446,.422,20,46,.435,22,48,70,49,21,11,28,43,194
Seth Curry,SG,29,DAL,20,9,427,55,126,.437,31,80,.388,24,46,.522,.560,29,31,.935,6,31,37,31,11,4,16,36,170
Stephen Curry,PG,31,GSW,4,4,112,27,66,.409,9,37,.243,18,29,.621,.477,18,18,1.000,4,16,20,26,5,2,15,10,81
Troy Daniels,SG,28,LAL,18,0,263,33,88,.375,23,66,.348,10,22,.455,.506,3,4,.750,4,22,26,7,7,1,6,13,92
Anthony Davis,PF,26,LAL,22,22,752,202,409,.494,25,73,.342,177,336,.527,.524,157,182,.863,53,148,201,69,31,60,51,52,586
Ed Davis,C,30,UTA,11,0,135,9,19,.474,0,0,NA,9,19,.474,.474,3,6,.500,14,38,52,5,4,6,9,28,21
Terence Davis,SG,22,TOR,21,0,331,51,106,.481,25,59,.424,26,47,.553,.599,14,15,.933,12,52,64,40,9,6,15,40,141
Dewayne Dedmon,C,30,SAC,21,4,305,42,103,.408,11,48,.229,31,55,.564,.461,11,13,.846,26,59,85,8,9,11,31,55,106
Matthew Dellavedova,PG,29,CLE,20,0,258,18,62,.290,4,35,.114,14,27,.519,.323,12,13,.923,5,21,26,42,8,1,15,29,52
DeMar DeRozan,SF,30,SAS,23,23,787,189,372,.508,5,14,.357,184,358,.514,.515,109,134,.813,12,118,130,111,22,11,59,66,492
Cheick Diallo,C,23,PHO,16,0,170,40,56,.714,1,1,1.000,39,55,.709,.723,15,17,.882,14,37,51,9,2,4,8,20,96
Hamidou Diallo,SF,21,OKC,12,1,256,46,92,.500,2,13,.154,44,79,.557,.511,11,18,.611,14,32,46,10,18,4,14,29,105
Gorgui Dieng,C,30,MIN,17,2,216,32,73,.438,8,25,.320,24,48,.500,.493,12,16,.750,16,55,71,20,12,17,11,24,84
Spencer Dinwiddie,SG,26,BRK,22,11,649,146,349,.418,43,135,.319,103,214,.481,.480,115,135,.852,5,58,63,134,20,11,59,76,450
Donte DiVincenzo,SG,23,MIL,20,10,421,64,152,.421,26,76,.342,38,76,.500,.507,20,26,.769,18,68,86,31,31,3,22,34,174
Luka Dončić,PG,20,DAL,22,22,734,212,442,.480,67,207,.324,145,235,.617,.555,171,210,.814,31,188,219,203,30,3,99,53,662
Luguentz Dort,G,20,OKC,1,0,7,0,1,.000,0,0,NA,0,1,.000,.000,0,0,NA,0,1,1,0,1,0,0,0,0
Damyean Dotson,SG,25,NYK,19,0,296,44,107,.411,19,62,.306,25,45,.556,.500,10,13,.769,3,27,30,19,9,4,11,18,117
Sekou Doumbouya,SF,19,DET,4,0,11,3,6,.500,0,1,.000,3,5,.600,.500,0,1,.000,0,2,2,0,0,0,0,3,6
Goran Dragić,PG,33,MIA,18,1,517,97,208,.466,39,96,.406,58,112,.518,.560,54,76,.711,6,52,58,90,12,4,47,32,287
Andre Drummond,C,26,DET,23,23,786,171,314,.545,0,12,.000,171,302,.566,.545,64,102,.627,109,282,391,72,40,45,86,88,406
Jared Dudley,SF,34,LAL,14,0,98,5,11,.455,5,8,.625,0,3,.000,.682,2,2,1.000,1,8,9,9,5,1,2,8,17
Kris Dunn,PG,25,CHI,23,4,493,65,154,.422,10,51,.196,55,103,.534,.455,9,13,.692,13,59,72,70,45,7,24,78,149
Carsen Edwards,SG,21,BOS,19,0,220,25,80,.313,15,48,.313,10,32,.313,.406,11,13,.846,5,29,34,17,7,2,11,21,76
Henry Ellenson,PF,23,BRK,1,0,3,0,0,NA,0,0,NA,0,0,NA,NA,0,0,NA,0,0,0,0,0,0,0,0,0
Wayne Ellington,SG,32,NYK,18,1,257,26,81,.321,21,69,.304,5,12,.417,.451,4,6,.667,1,28,29,16,5,2,12,20,77
Joel Embiid,C,25,PHI,18,18,546,130,283,.459,21,66,.318,109,217,.502,.496,126,155,.813,47,182,229,50,16,25,57,64,407
James Ennis,SF,29,PHI,23,0,398,57,113,.504,21,48,.438,36,65,.554,.597,32,42,.762,26,55,81,21,13,7,15,44,167
Drew Eubanks,PF,22,SAS,4,0,31,5,10,.500,0,0,NA,5,10,.500,.500,1,1,1.000,5,8,13,2,0,1,4,4,11
Jacob Evans,SG,22,GSW,3,0,43,5,12,.417,4,8,.500,1,4,.250,.583,4,4,1.000,1,4,5,2,0,0,1,2,18
Dante Exum,SG,24,UTA,10,0,76,8,19,.421,2,5,.400,6,14,.429,.474,2,2,1.000,3,6,9,5,1,2,9,8,20
Tacko Fall,C,24,BOS,1,0,4,2,4,.500,0,0,NA,2,4,.500,.500,0,0,NA,0,3,3,0,0,0,1,2,4
Derrick Favors,C,28,NOP,9,7,189,36,58,.621,1,2,.500,35,56,.625,.629,2,6,.333,31,49,80,19,5,4,14,21,75
Terrance Ferguson,SF,21,OKC,19,19,497,39,92,.424,23,65,.354,16,27,.593,.549,7,9,.778,11,25,36,19,10,6,14,57,108
Bruno Fernando,C,21,ATL,22,0,270,39,71,.549,4,14,.286,35,57,.614,.577,13,22,.591,26,36,62,24,5,9,21,35,95
Yogi Ferrell,PG,26,SAC,17,0,233,36,78,.462,8,24,.333,28,54,.519,.513,22,25,.880,4,20,24,30,8,1,13,16,102
Dorian Finney-Smith,PF,26,DAL,22,19,583,68,146,.466,25,78,.321,43,68,.632,.551,24,34,.706,39,69,108,22,13,10,21,42,185
Bryn Forbes,SG,26,SAS,23,23,619,105,251,.418,55,152,.362,50,99,.505,.528,31,37,.838,7,50,57,46,12,0,16,44,296
Evan Fournier,SG,27,ORL,22,22,675,152,312,.487,60,135,.444,92,177,.520,.583,70,83,.843,4,60,64,71,21,4,47,50,434
De'Aaron Fox,PG,22,SAC,9,9,288,55,128,.430,10,30,.333,45,98,.459,.469,44,62,.710,5,31,36,63,7,5,37,27,164
Melvin Frazier,SG,23,ORL,4,0,11,1,6,.167,0,1,.000,1,5,.200,.167,0,0,NA,1,0,1,1,0,0,0,1,2
Tim Frazier,PG,29,DET,13,4,138,9,42,.214,3,14,.214,6,28,.214,.250,11,14,.786,4,9,13,38,8,2,12,18,32
Markelle Fultz,PG,21,ORL,22,17,563,109,222,.491,8,37,.216,101,185,.546,.509,37,47,.787,10,48,58,85,28,4,40,46,263
Wenyen Gabriel,PF,22,SAC,7,0,47,5,16,.313,1,8,.125,4,8,.500,.344,5,9,.556,4,4,8,3,2,2,3,6,16
Daniel Gafford,C,21,CHI,14,0,147,25,34,.735,0,0,NA,25,34,.735,.735,10,21,.476,13,13,26,1,0,11,2,20,60
Danilo Gallinari,PF,31,OKC,21,21,636,119,265,.449,59,141,.418,60,124,.484,.560,93,101,.921,11,108,119,46,14,3,26,31,390
Langston Galloway,SG,28,DET,23,6,641,90,203,.443,57,134,.425,33,69,.478,.584,45,50,.900,8,41,49,36,14,7,17,28,282
Darius Garland,PG,20,CLE,22,22,624,91,242,.376,36,100,.360,55,142,.387,.450,23,27,.852,7,33,40,63,16,0,55,31,241
Marc Gasol,C,35,TOR,21,21,602,45,131,.344,26,71,.366,19,60,.317,.443,19,24,.792,14,119,133,73,13,22,28,68,135
Rudy Gay,PF,33,SAS,23,4,532,96,209,.459,20,73,.274,76,136,.559,.507,48,54,.889,31,105,136,44,10,13,38,34,260
Paul George,SF,29,LAC,12,12,355,87,195,.446,47,110,.427,40,85,.471,.567,51,55,.927,6,68,74,39,14,5,44,28,272
Taj Gibson,C,34,NYK,21,15,344,50,96,.521,2,9,.222,48,87,.552,.531,9,15,.600,41,52,93,25,14,5,14,46,111
Harry Giles,PF,21,SAC,7,0,52,11,25,.440,0,0,NA,11,25,.440,.440,2,2,1.000,3,4,7,5,2,3,5,13,24
Shai Gilgeous-Alexander,SG,21,OKC,21,21,730,144,327,.440,30,86,.349,114,241,.473,.486,73,90,.811,16,88,104,63,20,10,47,38,391
Rudy Gobert,C,27,UTA,21,21,712,112,168,.667,0,0,NA,112,168,.667,.667,74,120,.617,70,211,281,29,17,39,45,67,298
Brandon Goodwin,PG,24,ATL,2,0,5,0,1,.000,0,1,.000,0,0,NA,.000,0,0,NA,0,0,0,0,0,0,2,1,0
Aaron Gordon,PF,24,ORL,19,19,585,97,224,.433,24,74,.324,73,150,.487,.487,45,63,.714,27,96,123,55,13,9,25,41,263
Eric Gordon,SG,31,HOU,9,2,265,34,110,.309,21,74,.284,13,36,.361,.405,9,14,.643,3,14,17,7,5,2,12,21,98
Devonte' Graham,PG,24,CHO,24,14,807,149,362,.412,88,209,.421,61,153,.399,.533,73,89,.820,23,65,88,186,15,5,76,40,459
Treveon Graham,SG,26,MIN,20,17,465,46,133,.346,12,60,.200,34,73,.466,.391,18,22,.818,23,51,74,23,14,2,13,49,122
Jerami Grant,PF,25,DEN,20,0,439,69,155,.445,21,65,.323,48,90,.533,.513,25,42,.595,11,60,71,21,6,11,15,33,184
Josh Gray,PG,26,NOP,2,0,23,1,2,.500,0,0,NA,1,2,.500,.500,0,0,NA,1,1,2,2,0,0,5,1,2
Danny Green,SG,32,LAL,23,23,581,67,158,.424,43,112,.384,24,46,.522,.560,8,11,.727,15,68,83,28,29,12,23,54,185
Draymond Green,PF,29,GSW,15,15,417,45,113,.398,10,37,.270,35,76,.461,.442,25,35,.714,6,86,92,84,24,8,33,39,125
JaMychal Green,PF,29,LAC,21,0,464,55,132,.417,34,89,.382,21,43,.488,.545,18,21,.857,29,115,144,10,13,7,20,52,162
Javonte Green,SF,26,BOS,15,0,103,20,34,.588,3,10,.300,17,24,.708,.632,2,5,.400,3,12,15,4,4,1,3,11,45
Jeff Green,PF,33,UTA,23,2,443,61,153,.399,30,85,.353,31,68,.456,.497,43,54,.796,9,56,65,15,10,10,25,42,195
Blake Griffin,PF,30,DET,11,11,318,68,164,.415,22,68,.324,46,96,.479,.482,55,71,.775,12,43,55,38,4,4,29,16,213
Marko Guduric,SG,24,MEM,22,0,335,44,113,.389,17,55,.309,27,58,.466,.465,13,15,.867,11,35,46,33,7,5,24,22,118
Rui Hachimura,PF,21,WAS,21,21,614,127,259,.490,9,43,.209,118,216,.546,.508,33,38,.868,31,89,120,34,17,3,19,46,296
Devon Hall,SG,24,OKC,3,0,18,1,5,.200,0,2,.000,1,3,.333,.200,3,4,.750,0,1,1,2,0,0,1,1,5
Tim Hardaway,SG,27,DAL,22,9,534,93,225,.413,47,135,.348,46,90,.511,.518,41,50,.820,7,41,48,39,13,3,12,43,274
James Harden,SG,30,HOU,22,22,828,230,534,.431,104,307,.339,126,227,.555,.528,282,322,.876,22,113,135,162,44,12,108,71,846
Maurice Harkless,SF,26,LAC,23,13,509,50,104,.481,12,34,.353,38,70,.543,.538,11,22,.500,19,48,67,27,24,17,21,68,123
Jared Harper,PG,22,PHO,1,0,2,0,1,.000,0,1,.000,0,0,NA,.000,0,0,NA,0,0,0,0,0,0,0,0,0
Montrezl Harrell,C,26,LAC,23,2,678,178,298,.597,0,8,.000,178,290,.614,.597,75,120,.625,68,115,183,50,19,27,39,52,431
Gary Harris,SG,25,DEN,20,20,636,81,193,.420,29,80,.363,52,113,.460,.495,22,29,.759,10,52,62,36,24,6,19,42,213
Joe Harris,SF,28,BRK,22,22,696,123,252,.488,64,140,.457,59,112,.527,.615,17,22,.773,19,64,83,45,17,8,29,53,327
Tobias Harris,PF,27,PHI,23,23,781,172,351,.490,30,99,.303,142,252,.563,.533,61,77,.792,17,145,162,72,22,17,48,64,435
Shaquille Harrison,SF,26,CHI,13,4,124,18,44,.409,3,9,.333,15,35,.429,.443,9,16,.563,5,22,27,18,5,4,5,14,48
Josh Hart,SF,24,NOP,16,4,433,59,139,.424,35,96,.365,24,43,.558,.550,26,34,.765,17,82,99,20,17,6,20,44,179
Isaiah Hartenstein,C,21,HOU,8,0,96,11,15,.733,0,1,.000,11,14,.786,.733,9,11,.818,8,18,26,4,2,4,6,16,31
Udonis Haslem,PF,39,MIA,2,0,11,1,1,1.000,0,0,NA,1,1,1.000,1.000,3,4,.750,0,3,3,0,0,0,0,3,5
Jaxson Hayes,C,19,NOP,20,10,421,68,111,.613,0,2,.000,68,109,.624,.613,41,62,.661,42,51,93,13,15,22,18,64,177
Gordon Hayward,SF,29,BOS,8,8,249,61,110,.555,13,30,.433,48,80,.600,.614,16,19,.842,6,51,57,33,6,2,15,15,151
John Henson,PF,29,CLE,4,0,50,7,15,.467,0,4,.000,7,11,.636,.467,2,8,.250,5,8,13,5,3,6,4,4,16
Dewan Hernandez,C,23,TOR,3,0,9,1,5,.200,0,1,.000,1,4,.250,.200,2,2,1.000,2,5,7,0,1,0,1,5,4
Juan Hernangómez,PF,24,DEN,13,0,186,21,53,.396,12,33,.364,9,20,.450,.509,3,7,.429,8,25,33,11,1,3,9,12,57
Willy Hernangómez,C,25,CHO,7,0,57,9,20,.450,2,5,.400,7,15,.467,.500,4,8,.500,9,12,21,2,1,3,5,4,24
Tyler Herro,SG,20,MIA,21,3,596,107,239,.448,42,109,.385,65,130,.500,.536,37,45,.822,6,77,83,41,16,3,42,30,293
Mario Hezonja,PF,24,POR,20,4,353,32,90,.356,10,31,.323,22,59,.373,.411,21,25,.840,12,76,88,21,12,2,19,46,95
Buddy Hield,SG,27,SAC,21,21,720,159,389,.409,78,220,.355,81,169,.479,.509,45,53,.849,22,80,102,54,17,9,55,55,441
George Hill,PG,33,MIL,21,0,444,68,128,.531,32,62,.516,36,66,.545,.656,30,36,.833,21,40,61,68,17,2,15,33,198
Solomon Hill,SF,28,MEM,20,1,395,47,107,.439,23,57,.404,24,50,.480,.547,11,18,.611,11,53,64,37,20,1,17,33,128
Jaylen Hoard,SF,20,POR,3,0,11,1,2,.500,0,0,NA,1,2,.500,.500,0,0,NA,1,3,4,1,1,0,0,1,2
Aaron Holiday,PG,23,IND,21,9,449,72,180,.400,32,81,.395,40,99,.404,.489,11,12,.917,9,44,53,59,17,2,30,31,187
Jrue Holiday,SG,29,NOP,21,21,754,163,364,.448,37,111,.333,126,253,.498,.499,41,57,.719,26,78,104,141,41,15,69,52,404
Justin Holiday,SG,30,IND,23,2,579,62,145,.428,37,90,.411,25,55,.455,.555,19,23,.826,9,77,86,36,23,16,15,39,180
Rondae Hollis-Jefferson,SF,25,TOR,14,0,298,50,91,.549,0,2,.000,50,89,.562,.549,24,34,.706,39,44,83,22,10,5,17,26,124
Richaun Holmes,C,26,SAC,21,17,604,111,166,.669,0,0,NA,111,166,.669,.669,38,50,.760,59,122,181,22,19,30,20,86,260
Rodney Hood,SF,27,POR,21,21,619,87,172,.506,35,71,.493,52,101,.515,.608,21,27,.778,10,62,72,32,17,4,19,46,230
Al Horford,C,33,PHI,21,21,646,119,244,.488,33,83,.398,86,161,.534,.555,24,35,.686,37,107,144,82,23,21,24,49,295
Danuel House,SF,26,HOU,16,14,473,62,133,.466,40,91,.440,22,42,.524,.617,30,37,.811,17,53,70,22,19,10,14,35,194
Dwight Howard,C,34,LAL,23,0,458,63,84,.750,1,2,.500,62,82,.756,.756,33,65,.508,47,116,163,18,9,33,25,87,160
Kevin Huerter,SG,21,ATL,11,3,241,32,77,.416,17,45,.378,15,32,.469,.526,12,15,.800,6,30,36,30,7,4,17,22,93
De'Andre Hunter,SF,22,ATL,21,21,665,91,230,.396,36,99,.364,55,131,.420,.474,38,48,.792,11,75,86,36,13,5,38,55,256
Chandler Hutchison,SF,23,CHI,9,6,154,20,44,.455,5,12,.417,15,32,.469,.511,19,29,.655,1,32,33,8,5,2,12,12,64
Serge Ibaka,C,30,TOR,11,0,243,57,116,.491,9,26,.346,48,90,.533,.530,25,30,.833,14,56,70,11,6,11,24,29,148
Ersan İlyasova,PF,32,MIL,21,0,331,54,114,.474,15,52,.288,39,62,.629,.539,26,31,.839,27,71,98,13,10,6,6,38,149
Joe Ingles,SF,32,UTA,23,3,633,57,157,.363,32,102,.314,25,55,.455,.465,24,32,.750,5,88,93,89,21,2,37,53,170
Brandon Ingram,PF,22,NOP,19,19,637,168,341,.493,42,101,.416,126,240,.525,.554,89,107,.832,14,119,133,76,15,18,54,58,467
Kyrie Irving,PG,27,BRK,11,11,372,112,252,.444,31,91,.341,81,161,.503,.506,59,63,.937,10,49,59,79,12,6,26,32,314
Jonathan Isaac,SF,22,ORL,20,20,619,96,212,.453,24,72,.333,72,140,.514,.509,33,42,.786,35,109,144,28,27,55,32,45,249
Wesley Iwundu,SF,25,ORL,11,3,161,10,35,.286,1,9,.111,9,26,.346,.300,15,18,.833,4,19,23,9,5,3,4,9,36
Frank Jackson,PG,21,NOP,21,1,320,52,140,.371,20,65,.308,32,75,.427,.443,26,32,.813,5,25,30,22,9,1,21,32,150
Jaren Jackson,C,20,MEM,21,21,567,123,272,.452,44,115,.383,79,157,.503,.533,50,62,.806,27,75,102,29,11,24,39,86,340
Justin Jackson,PF,24,DAL,21,0,296,51,109,.468,23,55,.418,28,54,.519,.573,10,13,.769,9,45,54,9,5,2,4,21,135
Reggie Jackson,PG,29,DET,2,2,36,4,11,.364,1,5,.200,3,6,.500,.409,1,1,1.000,1,4,5,8,0,0,1,2,10
Justin James,SG,23,SAC,11,0,140,18,44,.409,3,14,.214,15,30,.500,.443,1,6,.167,2,18,20,9,4,6,5,11,40
LeBron James,PG,35,LAL,23,23,797,227,457,.497,46,135,.341,181,322,.562,.547,89,127,.701,22,138,160,246,30,13,84,38,589
Amile Jefferson,PF,26,ORL,4,0,12,3,3,1.000,0,0,NA,3,3,1.000,1.000,0,0,NA,2,2,4,2,0,0,1,2,6
DaQuan Jeffries,SG,22,SAC,2,0,11,1,1,1.000,0,0,NA,1,1,1.000,1.000,0,0,NA,1,0,1,1,0,0,0,1,2
Ty Jerome,PG,22,PHO,4,0,52,6,17,.353,3,6,.500,3,11,.273,.441,2,2,1.000,0,7,7,12,8,0,6,7,17
Alize Johnson,SF,23,IND,8,0,37,5,11,.455,0,0,NA,5,11,.455,.455,3,4,.750,6,6,12,2,0,0,1,4,13
B.J. Johnson,SF,24,ORL,1,0,3,0,0,NA,0,0,NA,0,0,NA,NA,0,0,NA,0,0,0,0,0,0,0,0,0
Cameron Johnson,PF,23,PHO,20,0,394,63,145,.434,40,97,.412,23,48,.479,.572,16,17,.941,19,40,59,16,12,7,14,37,182
James Johnson,PF,32,MIA,6,0,68,8,18,.444,2,9,.222,6,9,.667,.500,2,4,.500,2,9,11,4,3,2,4,5,20
Keldon Johnson,SF,20,SAS,1,0,2,0,1,.000,0,0,NA,0,1,.000,.000,0,0,NA,0,0,0,0,0,0,0,0,0
Stanley Johnson,PF,23,TOR,5,0,19,3,9,.333,1,4,.250,2,5,.400,.389,0,0,NA,2,5,7,0,1,0,4,6,7
Tyler Johnson,SG,27,PHO,19,3,364,44,111,.396,18,55,.327,26,56,.464,.477,18,24,.750,5,30,35,41,6,6,19,28,124
Nikola Jokić,C,24,DEN,20,20,617,128,276,.464,17,77,.221,111,199,.558,.495,41,52,.788,43,158,201,122,23,12,51,65,314
Damian Jones,C,24,ATL,21,13,397,68,95,.716,2,5,.400,66,90,.733,.726,29,43,.674,34,49,83,16,10,17,15,72,167
Derrick Jones,SF,22,MIA,8,0,106,15,30,.500,2,8,.250,13,22,.591,.533,6,8,.750,4,12,16,6,7,2,6,14,38
Tyus Jones,PG,23,MEM,22,5,453,55,146,.377,7,36,.194,48,110,.436,.401,18,25,.720,0,32,32,105,19,2,30,20,135
DeAndre Jordan,C,31,BRK,19,3,411,64,92,.696,0,0,NA,64,92,.696,.696,28,42,.667,44,134,178,39,8,21,20,39,156
Cory Joseph,PG,28,SAC,21,12,540,48,132,.364,8,35,.229,40,97,.412,.394,15,15,1.000,11,45,56,84,15,11,29,46,119
Mfiondu Kabengele,C,22,LAC,7,0,33,7,17,.412,4,9,.444,3,8,.375,.529,3,3,1.000,0,5,5,0,1,1,0,3,21
Frank Kaminsky,C,26,PHO,22,9,531,83,195,.426,24,79,.304,59,116,.509,.487,45,67,.672,24,95,119,48,8,9,24,48,235
Enes Kanter,C,27,BOS,14,3,221,40,68,.588,0,1,.000,40,67,.597,.588,23,35,.657,36,47,83,16,9,6,11,18,103
Luke Kennard,SG,23,DET,22,19,729,123,274,.449,58,142,.408,65,132,.492,.555,57,64,.891,6,70,76,94,11,4,32,51,361
Stanton Kidd,SF,27,UTA,4,0,15,0,3,.000,0,1,.000,0,2,.000,.000,0,0,NA,0,3,3,1,0,0,2,3,0
Michael Kidd-Gilchrist,PF,26,CHO,2,0,18,2,10,.200,1,3,.333,1,7,.143,.250,2,2,1.000,1,5,6,1,0,0,1,3,7
Maxi Kleber,C,28,DAL,21,5,521,58,135,.430,31,82,.378,27,53,.509,.544,27,30,.900,36,85,121,22,5,14,15,40,174
Brandon Knight,PG,28,CLE,8,0,95,14,40,.350,10,31,.323,4,9,.444,.475,2,6,.333,1,7,8,15,4,0,6,9,40
Kevin Knox,SF,20,NYK,22,3,437,56,149,.376,30,82,.366,26,67,.388,.477,31,47,.660,10,53,63,26,11,7,16,36,173
John Konchar,SG,23,MEM,1,0,7,0,0,NA,0,0,NA,0,0,NA,NA,0,0,NA,0,0,0,0,0,0,0,0,0
Furkan Korkmaz,SG,22,PHI,22,10,497,70,162,.432,37,101,.366,33,61,.541,.546,17,21,.810,4,47,51,19,7,5,18,35,194
Luke Kornet,C,24,CHI,12,0,132,15,46,.326,5,26,.192,10,20,.500,.380,5,5,1.000,5,15,20,6,2,10,3,12,40
Kyle Korver,SF,38,MIL,19,0,296,34,92,.370,29,77,.377,5,15,.333,.527,9,11,.818,6,24,30,15,8,4,16,19,106
Rodions Kurucs,PF,21,BRK,10,0,99,9,23,.391,3,7,.429,6,16,.375,.457,2,6,.333,5,17,22,1,5,0,12,16,23
Kyle Kuzma,PF,24,LAL,19,1,435,78,180,.433,31,86,.360,47,94,.500,.519,27,39,.692,7,60,67,16,6,8,34,34,214
Skal Labissière,C,23,POR,23,0,382,62,107,.579,2,8,.250,60,99,.606,.589,15,22,.682,45,69,114,25,6,24,23,61,141
Jeremy Lamb,SG,27,IND,14,14,462,86,181,.475,18,58,.310,68,123,.553,.525,34,39,.872,8,67,75,39,16,8,19,31,224
Romeo Langford,SG,20,BOS,1,0,0,0,0,NA,0,0,NA,0,0,NA,NA,0,0,NA,0,0,0,0,0,0,0,0,0
Zach LaVine,SG,24,CHI,23,23,744,178,408,.436,70,169,.414,108,239,.452,.522,92,114,.807,16,79,95,91,28,11,76,57,518
Jake Layman,PF,25,MIN,14,2,369,61,132,.462,19,54,.352,42,78,.538,.534,6,10,.600,12,29,41,11,12,10,18,31,147
T.J. Leaf,PF,22,IND,15,1,158,26,58,.448,5,11,.455,21,47,.447,.491,5,8,.625,20,37,57,6,7,3,6,14,62
Courtney Lee,SG,34,DAL,6,3,59,12,21,.571,6,11,.545,6,10,.600,.714,0,0,NA,0,2,2,3,0,2,1,5,30
Damion Lee,SG,27,GSW,11,0,241,35,91,.385,12,35,.343,23,56,.411,.451,28,33,.848,9,34,43,20,8,0,13,18,110
Alex Len,C,26,ATL,21,9,351,61,118,.517,4,26,.154,57,92,.620,.534,28,41,.683,26,67,93,19,10,17,21,45,154
Kawhi Leonard,SF,28,LAC,17,17,529,149,342,.436,27,85,.318,122,257,.475,.475,92,108,.852,19,112,131,89,33,14,57,34,417
Meyers Leonard,PF,27,MIA,22,22,410,53,90,.589,21,39,.538,32,51,.627,.706,5,9,.556,8,90,98,21,7,10,18,48,132
Caris LeVert,SG,25,BRK,9,9,284,59,140,.421,13,36,.361,46,104,.442,.468,20,31,.645,10,35,45,36,6,1,31,20,151
Damian Lillard,PG,29,POR,21,21,774,174,387,.450,67,185,.362,107,202,.530,.536,146,161,.907,11,88,99,156,22,10,60,42,561
Nassir Little,PF,19,POR,16,3,246,26,64,.406,5,27,.185,21,37,.568,.445,11,18,.611,16,39,55,8,7,6,9,31,68
Kevon Looney,C,23,GSW,4,2,45,6,16,.375,1,1,1.000,5,15,.333,.406,2,4,.500,8,7,15,2,0,2,4,7,15
Brook Lopez,C,31,MIL,21,21,556,72,183,.393,29,104,.279,43,79,.544,.473,41,44,.932,11,92,103,30,15,52,22,47,214
Robin Lopez,C,31,MIL,23,2,332,46,94,.489,13,38,.342,33,56,.589,.559,10,17,.588,26,39,65,15,4,16,29,40,115
Kevin Love,PF,31,CLE,18,18,547,88,200,.440,39,105,.371,49,95,.516,.538,75,85,.882,16,173,189,49,12,7,51,26,290
Kyle Lowry,PG,33,TOR,10,10,372,61,139,.439,32,84,.381,29,55,.527,.554,51,56,.911,5,40,45,71,11,4,32,29,205
Timothé Luwawu-Cabarrot,SG,24,BRK,2,0,6,0,2,.000,0,1,.000,0,1,.000,.000,1,2,.500,0,0,0,0,0,0,0,0,1
Trey Lyles,PF,24,SAS,23,14,397,38,88,.432,18,48,.375,20,40,.500,.534,5,9,.556,32,108,140,29,7,7,18,27,99
Daryl Macon,SG,24,MIA,3,0,13,1,3,.333,1,2,.500,0,1,.000,.500,0,0,NA,0,0,0,1,0,0,2,1,3
Josh Magette,PG,30,ORL,3,0,10,2,6,.333,0,0,NA,2,6,.333,.333,1,2,.500,1,2,3,2,2,0,3,0,5
Ian Mahinmi,C,33,WAS,1,0,13,2,5,.400,0,0,NA,2,5,.400,.400,3,4,.750,3,2,5,0,0,0,1,4,7
Thon Maker,C,22,DET,21,0,227,23,43,.535,7,14,.500,16,29,.552,.616,16,31,.516,10,27,37,9,6,13,11,30,69
Terance Mann,SG,23,LAC,18,3,156,19,37,.514,2,9,.222,17,28,.607,.541,7,8,.875,3,19,22,20,6,2,11,19,47
Boban Marjanović,C,31,DAL,10,1,131,31,56,.554,0,1,.000,31,55,.564,.554,13,16,.813,15,40,55,7,2,3,9,18,75
Lauri Markkanen,PF,22,CHI,23,23,684,99,267,.371,43,137,.314,56,130,.431,.451,79,97,.814,21,134,155,39,20,12,45,45,320
Caleb Martin,SF,24,CHO,3,0,25,2,9,.222,0,3,.000,2,6,.333,.222,1,3,.333,0,4,4,3,1,2,3,2,5
Cody Martin,SF,24,CHO,16,0,189,15,42,.357,1,18,.056,14,24,.583,.369,15,22,.682,8,28,36,18,13,1,7,19,46
Kelan Martin,SF,24,MIN,9,0,123,15,44,.341,5,24,.208,10,20,.500,.398,0,0,NA,2,24,26,3,1,1,4,20,35
Frank Mason,PG,25,MIL,2,0,10,1,4,.250,1,2,.500,0,2,.000,.375,1,2,.500,0,0,0,2,0,0,0,1,4
Garrison Mathews,SG,23,WAS,2,0,14,0,2,.000,0,2,.000,0,0,NA,.000,0,0,NA,0,1,1,2,0,0,1,3,0
Wesley Matthews,SG,33,MIL,23,23,553,65,146,.445,38,100,.380,27,46,.587,.575,23,27,.852,4,50,54,33,12,2,19,27,191
Patrick McCaw,SF,24,TOR,2,0,40,3,5,.600,1,3,.333,2,2,1.000,.700,1,2,.500,2,4,6,3,3,0,3,3,8
CJ McCollum,SG,28,POR,23,23,836,204,453,.450,61,157,.389,143,296,.483,.518,39,47,.830,18,84,102,88,17,21,46,64,508
T.J. McConnell,PG,27,IND,21,0,359,62,126,.492,1,4,.250,61,122,.500,.496,8,9,.889,9,47,56,105,11,3,31,27,133
Jalen McDaniels,PF,22,CHO,1,0,3,1,2,.500,0,0,NA,1,2,.500,.500,0,0,NA,1,0,1,0,0,0,0,0,2
Doug McDermott,PF,28,IND,23,0,468,79,174,.454,39,86,.453,40,88,.455,.566,13,15,.867,9,51,60,28,3,3,19,43,210
JaVale McGee,C,32,LAL,23,23,380,75,123,.610,0,0,NA,75,123,.610,.610,17,26,.654,45,97,142,15,14,28,18,50,167
Rodney McGruder,SG,28,LAC,15,2,260,23,60,.383,11,35,.314,12,25,.480,.475,3,8,.375,11,25,36,12,4,3,7,26,60
Alfonzo McKinnie,SF,27,CLE,16,0,172,17,48,.354,8,24,.333,9,24,.375,.438,7,11,.636,9,26,35,3,5,3,8,20,49
Jordan McLaughlin,PG,23,MIN,4,0,57,4,15,.267,1,8,.125,3,7,.429,.300,2,2,1.000,1,6,7,8,1,0,4,4,11
Ben McLemore,SG,26,HOU,22,7,482,72,176,.409,52,148,.351,20,28,.714,.557,25,29,.862,8,44,52,20,15,4,19,45,221
Jordan McRae,SG,28,WAS,13,0,235,43,91,.473,13,33,.394,30,58,.517,.544,17,19,.895,3,28,31,36,8,4,14,26,116
Nicolò Melli,C,29,NOP,21,3,336,40,98,.408,22,67,.328,18,31,.581,.520,17,22,.773,14,44,58,24,14,4,16,40,119
De'Anthony Melton,PG,21,MEM,11,0,154,21,53,.396,5,16,.313,16,37,.432,.443,13,15,.867,8,24,32,31,13,2,13,16,60
Chimezie Metu,PF,22,SAS,6,0,21,7,12,.583,0,0,NA,7,12,.583,.583,2,4,.500,7,4,11,2,0,2,0,0,16
Khris Middleton,SF,28,MIL,16,13,435,102,207,.493,32,80,.400,70,127,.551,.570,42,47,.894,13,76,89,53,13,2,27,38,278
C.J. Miles,SG,32,WAS,10,0,161,19,59,.322,11,35,.314,8,24,.333,.415,15,20,.750,4,8,12,12,10,4,4,14,64
Malcolm Miller,SF,26,TOR,8,1,48,6,11,.545,5,10,.500,1,1,1.000,.773,1,4,.250,0,5,5,4,0,1,2,5,18
Patty Mills,PG,31,SAS,23,1,538,90,196,.459,47,113,.416,43,83,.518,.579,29,37,.784,4,28,32,53,21,4,24,35,256
Paul Millsap,PF,34,DEN,20,20,515,90,187,.481,24,50,.480,66,137,.482,.545,61,70,.871,41,78,119,27,17,16,25,56,265
Shake Milton,SG,23,PHI,9,0,82,12,35,.343,4,19,.211,8,16,.500,.400,7,9,.778,1,7,8,7,1,0,12,13,35
Donovan Mitchell,SG,23,UTA,23,23,795,207,471,.439,53,141,.376,154,330,.467,.496,99,119,.832,21,87,108,83,30,6,54,52,566
Naz Mitrou-Long,SG,26,IND,3,0,43,6,16,.375,2,11,.182,4,5,.800,.438,0,0,NA,0,6,6,7,1,1,2,1,14
Malik Monk,SG,21,CHO,24,0,500,86,195,.441,24,91,.264,62,104,.596,.503,28,33,.848,7,56,63,54,10,6,35,38,224
E'Twaun Moore,SG,30,NOP,16,3,326,59,140,.421,21,55,.382,38,85,.447,.496,14,22,.636,13,38,51,23,8,1,11,27,153
Ja Morant,PG,20,MEM,17,17,488,118,258,.457,16,39,.410,102,219,.466,.488,65,85,.765,16,38,54,109,23,5,58,29,317
Juwan Morgan,PF,22,UTA,2,0,5,0,0,NA,0,0,NA,0,0,NA,NA,0,0,NA,0,2,2,0,0,0,1,1,0
Marcus Morris,SF,30,NYK,21,21,687,127,299,.425,60,120,.500,67,179,.374,.525,76,90,.844,23,99,122,27,19,13,37,66,390
Markieff Morris,PF,30,DET,22,12,489,85,179,.475,34,83,.410,51,96,.531,.570,24,32,.750,12,70,82,35,14,4,35,53,228
Monte Morris,PG,24,DEN,20,0,345,56,129,.434,9,23,.391,47,106,.443,.469,21,28,.750,4,31,35,67,9,5,14,16,142
Johnathan Motley,PF,24,LAC,2,0,4,1,3,.333,1,1,1.000,0,2,.000,.500,0,0,NA,1,1,2,2,0,0,2,1,3
Emmanuel Mudiay,PG,23,UTA,20,0,312,59,124,.476,9,30,.300,50,94,.532,.512,20,25,.800,6,44,50,49,6,4,36,32,147
Dejounte Murray,PG,23,SAS,20,13,452,76,168,.452,5,26,.192,71,142,.500,.467,37,47,.787,25,96,121,81,32,5,45,46,194
Jamal Murray,PG,22,DEN,20,20,656,138,315,.438,33,100,.330,105,215,.488,.490,52,58,.897,16,72,88,95,32,8,46,35,361
Džanan Musa,SF,20,BRK,17,0,265,26,85,.306,7,41,.171,19,44,.432,.347,22,29,.759,8,37,45,24,7,1,22,16,81
Mike Muscala,C,28,OKC,13,0,150,15,52,.288,10,39,.256,5,13,.385,.385,7,8,.875,6,27,33,14,3,3,5,20,47
Sviatoslav Mykhailiuk,SF,22,DET,18,1,304,34,82,.415,27,60,.450,7,22,.318,.579,5,6,.833,4,18,22,24,6,1,16,21,100
Abdel Nader,SF,26,OKC,14,1,216,32,66,.485,13,33,.394,19,33,.576,.583,18,22,.818,4,21,25,8,3,5,15,15,95
Larry Nance,C,27,CLE,20,4,525,78,154,.506,24,65,.369,54,89,.607,.584,22,31,.710,40,107,147,30,19,10,21,35,202
Shabazz Napier,PG,28,MIN,9,0,167,19,56,.339,9,37,.243,10,19,.526,.420,19,22,.864,1,19,20,28,10,3,14,8,66
Raul Neto,PG,27,PHI,20,2,247,37,74,.500,13,27,.481,24,47,.511,.588,3,4,.750,3,17,20,33,9,2,18,12,90
Georges Niang,PF,26,UTA,17,0,188,25,54,.463,13,33,.394,12,21,.571,.583,7,10,.700,1,27,28,9,0,2,10,25,70
Nerlens Noel,C,25,OKC,20,3,371,59,91,.648,0,0,NA,59,91,.648,.648,31,40,.775,25,68,93,30,19,32,22,59,149
Zach Norvell,SG,22,LAL,2,0,5,0,1,.000,0,0,NA,0,1,.000,.000,0,0,NA,0,1,1,0,0,0,0,0,0
Jaylen Nowell,SG,20,MIN,2,0,15,1,4,.250,0,3,.000,1,1,1.000,.250,1,1,1.000,0,1,1,3,0,0,1,1,3
Frank Ntilikina,PG,21,NYK,21,17,538,51,133,.383,19,54,.352,32,79,.405,.455,13,17,.765,8,37,45,71,27,10,24,55,134
Kendrick Nunn,SG,24,MIA,22,22,647,134,304,.441,45,129,.349,89,175,.509,.515,22,29,.759,7,48,55,75,24,7,46,58,335
David Nwaba,SF,27,BRK,14,0,170,21,36,.583,7,14,.500,14,22,.636,.681,8,14,.571,7,23,30,5,5,9,6,22,57
Royce O'Neale,PF,26,UTA,23,21,654,49,99,.495,29,62,.468,20,37,.541,.641,12,14,.857,3,106,109,59,18,6,21,69,139
Kyle O'Quinn,C,29,PHI,14,0,147,23,43,.535,5,13,.385,18,30,.600,.593,2,6,.333,16,38,54,20,2,11,15,22,53
Semi Ojeleye,PF,25,BOS,21,1,302,21,51,.412,11,31,.355,10,20,.500,.520,7,10,.700,7,33,40,8,6,1,5,24,60
Jahlil Okafor,C,24,NOP,14,6,252,52,83,.627,1,2,.500,51,81,.630,.633,24,36,.667,23,41,64,20,5,14,24,41,129
Elie Okobo,PG,22,PHO,15,0,150,21,52,.404,10,25,.400,11,27,.407,.500,11,19,.579,2,13,15,38,4,0,4,8,63
Josh Okogie,SG,21,MIN,19,4,470,52,118,.441,13,45,.289,39,73,.534,.496,46,61,.754,29,71,100,33,20,7,30,43,163
KZ Okpala,SF,20,MIA,2,0,3,0,0,NA,0,0,NA,0,0,NA,NA,0,0,NA,0,1,1,0,0,0,1,0,0
Kelly Olynyk,C,28,MIA,22,0,513,69,147,.469,37,86,.430,32,61,.525,.595,29,33,.879,22,89,111,31,21,9,31,61,204
Miye Oni,SG,22,UTA,3,0,8,0,0,NA,0,0,NA,0,0,NA,NA,0,0,NA,0,1,1,0,0,0,1,0,0
Cedi Osman,SF,24,CLE,22,22,648,78,182,.429,35,95,.368,43,87,.494,.525,20,30,.667,9,68,77,46,24,6,28,50,211
Kelly Oubre,SF,24,PHO,22,22,707,133,301,.442,33,101,.327,100,200,.500,.497,80,104,.769,31,102,133,34,31,16,36,72,379
Jabari Parker,PF,24,ATL,22,17,617,146,293,.498,22,84,.262,124,209,.593,.536,39,54,.722,42,97,139,42,33,10,41,71,353
Chandler Parsons,SF,31,ATL,3,0,35,4,12,.333,3,10,.300,1,2,.500,.458,0,0,NA,1,3,4,2,4,0,1,3,11
Eric Paschall,PF,23,GSW,23,17,734,145,286,.507,17,56,.304,128,230,.557,.537,86,106,.811,34,89,123,41,9,8,38,47,393
Patrick Patterson,PF,30,LAC,21,11,293,35,88,.398,29,69,.420,6,19,.316,.563,6,10,.600,14,46,60,17,3,2,7,18,105
Justin Patton,C,22,OKC,2,0,9,1,3,.333,0,1,.000,1,2,.500,.333,0,0,NA,0,2,2,0,0,0,1,4,2
Chris Paul,PG,34,OKC,21,21,651,107,235,.455,33,88,.375,74,147,.503,.526,85,95,.895,6,81,87,126,32,2,38,51,332
Elfrid Payton,PG,25,NYK,6,3,130,16,41,.390,6,10,.600,10,31,.323,.463,7,8,.875,5,12,17,24,13,1,12,10,45
Norvel Pelle,SF,26,PHI,2,0,25,2,3,.667,0,0,NA,2,3,.667,.667,4,6,.667,2,8,10,2,0,4,2,4,8
Theo Pinson,SG,24,BRK,13,0,195,23,86,.267,8,41,.195,15,45,.333,.314,11,12,.917,7,22,29,31,7,0,19,20,65
Mason Plumlee,C,29,DEN,20,0,336,58,96,.604,0,3,.000,58,93,.624,.604,27,51,.529,36,81,117,46,15,15,31,54,143
Vincent Poirier,C,26,BOS,8,0,35,5,10,.500,0,0,NA,5,10,.500,.500,1,2,.500,6,4,10,3,1,2,3,8,11
Jakob Pöltl,C,24,SAS,23,7,435,60,101,.594,0,0,NA,60,101,.594,.594,19,34,.559,53,86,139,35,14,31,21,42,139
Shamorie Ponds,PG,21,TOR,2,0,8,2,4,.500,0,1,.000,2,3,.667,.500,0,0,NA,0,1,1,2,0,1,0,2,4
Jordan Poole,SG,20,GSW,24,9,576,59,229,.258,29,118,.246,30,111,.270,.321,42,49,.857,4,50,54,49,15,6,29,44,189
Kevin Porter,SF,19,CLE,21,1,437,55,135,.407,13,49,.265,42,86,.488,.456,21,27,.778,8,61,69,40,16,4,32,52,144
Michael Porter,PF,21,DEN,12,0,103,21,45,.467,5,15,.333,16,30,.533,.522,5,8,.625,10,19,29,5,0,3,8,14,52
Otto Porter,SF,26,CHI,9,9,226,35,84,.417,16,40,.400,19,44,.432,.512,15,20,.750,8,23,31,14,9,3,7,20,101
Bobby Portis,C,24,NYK,23,2,502,79,198,.399,23,65,.354,56,133,.421,.457,18,25,.720,36,96,132,25,15,8,21,40,199
Kristaps Porziņģis,PF,24,DAL,21,21,628,123,312,.394,43,126,.341,80,186,.430,.463,59,84,.702,36,147,183,29,12,43,34,62,348
Dwight Powell,C,28,DAL,19,16,480,65,95,.684,6,13,.462,59,82,.720,.716,21,39,.538,30,58,88,23,16,8,18,50,157
Norman Powell,SG,26,TOR,21,11,593,100,212,.472,37,99,.374,63,113,.558,.559,44,53,.830,10,73,83,33,20,7,30,37,281
Julius Randle,PF,25,NYK,23,23,738,140,321,.436,19,80,.238,121,241,.502,.466,86,130,.662,56,142,198,79,17,3,74,65,385
Cam Reddish,SF,20,ATL,19,16,467,54,170,.318,18,73,.247,36,97,.371,.371,28,37,.757,13,57,70,30,19,7,32,34,154
J.J. Redick,SG,35,NOP,22,18,631,105,237,.443,74,159,.465,31,78,.397,.599,58,67,.866,4,66,70,43,10,5,29,38,342
Josh Richardson,SG,26,PHI,16,16,512,93,204,.456,32,83,.386,61,121,.504,.534,40,50,.800,10,45,55,58,18,10,37,47,258
Austin Rivers,SG,27,HOU,22,1,547,67,162,.414,31,95,.326,36,67,.537,.509,20,28,.714,17,43,60,34,11,4,15,44,185
Duncan Robinson,SF,25,MIA,22,17,576,82,176,.466,62,145,.428,20,31,.645,.642,15,16,.938,2,62,64,17,16,8,16,57,241
Glenn Robinson,SF,26,GSW,24,24,770,113,246,.459,30,77,.390,83,169,.491,.520,27,32,.844,36,74,110,43,22,7,22,39,283
Jerome Robinson,SG,22,LAC,18,0,225,27,80,.338,11,35,.314,16,45,.356,.406,5,8,.625,2,28,30,19,6,7,13,24,70
Justin Robinson,PG,22,WAS,4,0,12,2,5,.400,1,1,1.000,1,4,.250,.500,0,0,NA,1,2,3,2,0,0,2,0,5
Mitchell Robinson,C,21,NYK,19,6,403,69,101,.683,0,0,NA,69,101,.683,.683,37,59,.627,55,72,127,12,14,37,16,65,175
Rajon Rondo,PG,33,LAL,13,0,272,42,91,.462,19,36,.528,23,55,.418,.566,8,11,.727,4,42,46,76,14,1,24,13,111
Derrick Rose,PG,31,DET,18,1,423,113,233,.485,13,40,.325,100,193,.518,.513,45,52,.865,8,28,36,103,15,7,45,20,284
Terrence Ross,SG,28,ORL,20,0,482,91,222,.410,39,125,.312,52,97,.536,.498,39,45,.867,6,52,58,20,19,6,24,36,260
Terry Rozier,PG,25,CHO,24,24,783,152,344,.442,67,160,.419,85,184,.462,.539,59,68,.868,17,88,105,101,29,4,67,55,430
Ricky Rubio,PG,29,PHO,17,17,536,75,195,.385,18,62,.290,57,133,.429,.431,44,54,.815,11,71,82,152,24,3,33,46,212
D'Angelo Russell,SG,23,GSW,12,12,368,94,209,.450,33,95,.347,61,114,.535,.529,47,62,.758,3,42,45,74,8,5,40,21,268
Domantas Sabonis,C,23,IND,21,21,722,153,295,.519,5,24,.208,148,271,.546,.527,75,96,.781,75,200,275,78,16,12,60,79,386
JaKarr Sampson,SF,26,IND,9,7,166,23,41,.561,2,10,.200,21,31,.677,.585,2,7,.286,7,17,24,4,5,6,6,23,50
Dario Šarić,PF,25,PHO,22,22,616,86,203,.424,36,104,.346,50,99,.505,.512,31,36,.861,42,116,158,46,19,10,30,58,239
Tomáš Satoranský,PG,28,CHI,23,23,624,79,177,.446,27,68,.397,52,109,.477,.523,35,40,.875,19,58,77,123,35,3,50,49,220
Admiral Schofield,SF,22,WAS,8,0,71,7,12,.583,4,9,.444,3,3,1.000,.750,4,4,1.000,2,7,9,1,0,0,2,7,22
Dennis Schröder,PG,26,OKC,21,0,609,132,292,.452,29,96,.302,103,196,.526,.502,44,56,.786,8,73,81,77,16,7,58,48,337
Mike Scott,PF,31,PHI,23,1,442,52,121,.430,25,74,.338,27,47,.574,.533,10,11,.909,18,61,79,17,6,2,10,37,139
Thabo Sefolosha,PF,35,HOU,19,0,201,16,46,.348,8,28,.286,8,18,.444,.435,0,1,.000,11,34,45,15,9,4,6,19,40
Collin Sexton,SG,21,CLE,22,22,669,149,342,.436,25,78,.321,124,264,.470,.472,67,83,.807,20,48,68,52,20,1,41,45,390
Landry Shamet,SG,22,LAC,10,10,294,30,77,.390,21,58,.362,9,19,.474,.526,10,10,1.000,0,15,15,17,4,1,12,31,91
Iman Shumpert,SG,29,BRK,11,0,207,19,57,.333,7,31,.226,12,26,.462,.395,3,5,.600,9,22,31,10,12,2,10,19,48
Pascal Siakam,PF,25,TOR,21,21,774,197,425,.464,50,133,.376,147,292,.503,.522,82,100,.820,33,148,181,79,19,15,60,61,526
Chris Silva,PF,23,MIA,20,0,197,28,41,.683,0,2,.000,28,39,.718,.683,20,28,.714,37,43,80,13,5,14,24,54,76
Ben Simmons,PG,23,PHI,21,21,713,123,218,.564,2,4,.500,121,214,.565,.569,50,85,.588,31,109,140,177,51,12,79,71,298
Anfernee Simons,SG,20,POR,23,1,492,86,206,.417,33,98,.337,53,108,.491,.498,29,39,.744,5,37,42,36,10,2,24,43,234
Marcus Smart,SG,25,BOS,20,15,635,82,212,.387,42,126,.333,40,86,.465,.486,29,33,.879,19,48,67,91,26,9,25,46,235
Dennis Smith,PG,22,NYK,16,1,279,32,100,.320,9,31,.290,23,69,.333,.365,14,25,.560,11,18,29,46,7,5,26,36,87
Ish Smith,PG,31,WAS,21,7,512,78,172,.453,18,49,.367,60,123,.488,.506,12,18,.667,11,49,60,91,16,7,22,35,186
Tony Snell,SF,28,DET,19,17,485,54,115,.470,36,80,.450,18,35,.514,.626,4,4,1.000,5,28,33,28,7,2,9,36,148
Omari Spellman,PF,22,GSW,23,0,421,64,148,.432,17,48,.354,47,100,.470,.490,34,41,.829,52,77,129,23,16,16,33,27,179
Max Strus,SG,23,CHI,2,0,6,2,3,.667,0,1,.000,2,2,1.000,.667,1,1,1.000,1,0,1,0,0,0,0,1,5
Edmond Sumner,PG,24,IND,3,2,67,9,18,.500,0,3,.000,9,15,.600,.500,3,5,.600,1,2,3,6,5,1,1,9,21
Caleb Swanigan,PF,22,SAC,4,0,11,1,2,.500,0,0,NA,1,2,.500,.500,1,2,.500,1,3,4,0,1,2,3,3,3
Jayson Tatum,PF,21,BOS,21,21,721,161,391,.412,51,143,.357,110,248,.444,.477,72,87,.828,27,120,147,60,30,15,45,48,445
Jeff Teague,PG,31,MIN,17,12,502,68,157,.433,14,44,.318,54,113,.478,.478,71,82,.866,8,39,47,127,16,5,37,37,221
Garrett Temple,SG,33,BRK,22,13,605,77,185,.416,48,133,.361,29,52,.558,.546,19,25,.760,10,58,68,50,21,13,24,46,221
Daniel Theis,C,27,BOS,18,17,387,47,94,.500,3,15,.200,44,79,.557,.516,21,31,.677,29,91,120,24,9,28,15,56,118
Isaiah Thomas,PG,30,WAS,17,14,424,82,184,.446,34,83,.410,48,101,.475,.538,16,20,.800,3,28,31,86,8,4,37,37,214
Khyri Thomas,SG,23,DET,2,0,6,0,0,NA,0,0,NA,0,0,NA,NA,1,2,.500,0,0,0,0,0,0,0,0,1
Matt Thomas,SG,25,TOR,12,0,136,20,37,.541,14,26,.538,6,11,.545,.730,3,5,.600,1,12,13,4,4,0,4,12,57
Tristan Thompson,C,28,CLE,21,21,651,121,237,.511,3,7,.429,118,230,.513,.517,41,67,.612,83,128,211,51,18,25,31,54,286
Matisse Thybulle,SG,22,PHI,22,3,352,30,75,.400,17,42,.405,13,33,.394,.513,12,17,.706,4,18,22,27,31,16,21,50,89
Anthony Tolliver,PF,34,POR,17,7,280,17,58,.293,13,46,.283,4,12,.333,.405,9,11,.818,10,43,53,11,4,6,11,23,56
Karl-Anthony Towns,C,24,MIN,19,19,637,170,332,.512,72,166,.434,98,166,.590,.620,85,106,.802,49,178,227,85,20,27,58,64,497
Gary Trent,SG,21,POR,11,1,93,15,33,.455,11,23,.478,4,10,.400,.621,0,0,NA,3,9,12,5,2,2,2,7,41
Allonzo Trier,PG,24,NYK,11,1,142,24,46,.522,12,27,.444,12,19,.632,.652,23,28,.821,1,16,17,14,2,3,16,22,83
P.J. Tucker,PF,34,HOU,22,22,788,78,151,.517,43,97,.443,35,54,.648,.659,16,20,.800,33,112,145,32,30,12,22,75,215
Evan Turner,PG,31,ATL,14,0,195,23,58,.397,0,4,.000,23,54,.426,.397,12,14,.857,7,22,29,32,8,8,20,16,58
Myles Turner,C,23,IND,15,15,466,61,141,.433,22,60,.367,39,81,.481,.511,25,34,.735,22,63,85,16,11,37,24,38,169
Jonas Valančiūnas,C,27,MEM,20,20,493,120,208,.577,10,30,.333,110,178,.618,.601,36,45,.800,53,143,196,37,8,18,45,55,286
Denzel Valentine,SF,26,CHI,9,0,84,18,42,.429,12,27,.444,6,15,.400,.571,0,0,NA,2,17,19,8,4,1,2,8,48
Jarred Vanderbilt,SF,20,DEN,3,0,9,0,0,NA,0,0,NA,0,0,NA,NA,0,0,NA,0,2,2,1,0,0,1,0,0
Fred VanVleet,PG,25,TOR,21,21,794,126,307,.410,58,146,.397,68,161,.422,.505,83,95,.874,4,78,82,153,43,3,51,51,393
Noah Vonleh,C,24,MIN,14,1,177,20,43,.465,1,10,.100,19,33,.576,.477,16,19,.842,17,34,51,15,4,3,13,20,57
Nikola Vučević,C,29,ORL,14,14,431,95,211,.450,16,50,.320,79,161,.491,.488,33,39,.846,41,121,162,49,9,15,20,27,239
Dean Wade,PF,23,CLE,3,0,18,1,2,.500,1,1,1.000,0,1,.000,.750,0,0,NA,0,2,2,0,1,0,0,3,3
Moritz Wagner,C,22,WAS,19,2,386,88,150,.587,20,52,.385,68,98,.694,.653,32,38,.842,30,85,115,25,15,12,42,75,228
Kemba Walker,PG,29,BOS,20,20,642,142,344,.413,70,177,.395,72,167,.431,.515,82,90,.911,21,70,91,100,20,11,44,35,436
Lonnie Walker,SG,21,SAS,16,0,128,27,62,.435,6,16,.375,21,46,.457,.484,5,13,.385,6,15,21,8,4,2,7,11,65
Tyrone Wallace,SG,25,ATL,14,0,160,14,44,.318,1,15,.067,13,29,.448,.330,11,17,.647,3,19,22,13,7,1,10,19,40
Taurean Waller-Prince,SF,25,BRK,22,22,668,108,259,.417,62,152,.408,46,107,.430,.537,21,29,.724,19,112,131,47,19,8,47,59,299
Derrick Walton,PG,24,LAC,7,0,32,2,6,.333,1,4,.250,1,2,.500,.417,3,3,1.000,1,0,1,4,1,0,1,4,8
Brad Wanamaker,PG,30,BOS,21,0,369,51,105,.486,11,29,.379,40,76,.526,.538,44,49,.898,9,34,43,60,16,5,24,35,157
T.J. Warren,SF,26,IND,23,23,764,175,340,.515,30,74,.405,145,266,.545,.559,50,61,.820,17,59,76,24,25,7,31,63,430
PJ Washington,PF,21,CHO,24,24,676,109,222,.491,32,76,.421,77,146,.527,.563,32,50,.640,22,97,119,41,26,19,30,66,282
Yuta Watanabe,SG,25,MEM,3,0,11,3,5,.600,1,1,1.000,2,4,.500,.700,0,0,NA,0,2,2,0,0,1,0,1,7
Tremont Waters,PG,22,BOS,1,0,20,2,7,.286,1,5,.200,1,2,.500,.357,2,2,1.000,0,2,2,3,1,2,2,2,7
Russell Westbrook,PG,31,HOU,20,20,687,162,399,.406,23,105,.219,139,294,.473,.435,90,122,.738,34,133,167,149,32,8,90,78,437
Coby White,SG,19,CHI,23,0,570,104,283,.367,48,137,.350,56,146,.384,.452,31,40,.775,6,75,81,48,17,0,31,31,287
Derrick White,SG,25,SAS,21,9,501,71,157,.452,20,51,.392,51,106,.481,.516,41,52,.788,11,37,48,61,9,15,26,50,203
Hassan Whiteside,C,30,POR,20,20,561,126,209,.603,0,0,NA,126,209,.603,.603,56,75,.747,72,178,250,25,10,42,41,60,308
Andrew Wiggins,SF,24,MIN,17,17,591,158,351,.450,39,113,.345,119,238,.500,.506,68,95,.716,22,70,92,57,11,22,33,41,423
Grant Williams,PF,21,BOS,20,1,287,14,57,.246,0,25,.000,14,32,.438,.246,14,17,.824,14,30,44,17,8,12,15,38,42
Kenrich Williams,PF,25,NOP,21,11,522,43,101,.426,21,63,.333,22,38,.579,.530,9,22,.409,33,88,121,36,19,16,16,55,116
Lou Williams,SG,33,LAC,23,3,712,154,365,.422,40,112,.357,114,253,.451,.477,128,151,.848,12,64,76,142,13,3,75,36,476
Marvin Williams,PF,33,CHO,24,0,487,63,127,.496,30,75,.400,33,52,.635,.614,27,30,.900,9,57,66,23,16,10,16,40,183
Robert Williams,C,22,BOS,19,1,269,33,49,.673,0,0,NA,33,49,.673,.673,8,14,.571,23,64,87,21,17,21,16,34,74
Nigel Williams-Goss,PG,25,UTA,6,0,19,0,5,.000,0,1,.000,0,4,.000,.000,2,2,1.000,1,1,2,2,0,1,1,1,2
D.J. Wilson,PF,23,MIL,11,0,127,23,46,.500,10,29,.345,13,17,.765,.609,1,1,1.000,4,21,25,9,0,1,6,11,57
Justise Winslow,SF,23,MIA,10,5,337,50,127,.394,6,26,.231,44,101,.436,.417,18,27,.667,16,55,71,43,6,4,23,36,124
Christian Wood,PF,24,DET,21,0,315,71,115,.617,15,31,.484,56,84,.667,.683,31,47,.660,26,67,93,12,7,19,20,17,188
Delon Wright,SG,27,DAL,22,2,466,62,129,.481,13,37,.351,49,92,.533,.531,28,34,.824,17,58,75,74,25,7,15,27,165
Thaddeus Young,PF,31,CHI,22,0,467,76,190,.400,24,72,.333,52,118,.441,.463,17,29,.586,37,58,95,36,21,7,35,36,193
Trae Young,PG,21,ATL,21,21,726,199,430,.463,72,183,.393,127,247,.514,.547,133,156,.853,10,74,84,176,28,1,106,25,603
Cody Zeller,C,27,CHO,21,17,496,96,181,.530,13,37,.351,83,144,.576,.566,32,50,.640,63,99,162,25,10,10,35,52,237
Ante Žižić,C,23,CLE,7,0,82,13,24,.542,0,0,NA,13,24,.542,.542,5,6,.833,7,14,21,0,2,1,1,9,31
Ivica Zubac,C,22,LAC,23,21,377,74,125,.592,0,2,.000,74,123,.602,.592,43,52,.827,54,99,153,20,4,24,21,56,191
