Player,Pos,Age,Tm,G,GS,MP,FG,FGA,FG%,3P,3PA,3P%,2P,2PA,2P%,eFG%,FT,FTA,FT%,ORB,DRB,TRB,AST,STL,BLK,TOV,PF,PTS
Steven Adams,C,26,OKC,20,20,542,92,149,.617,0,1,.000,92,148,.622,.617,32,59,.542,60,126,186,58,10,25,29,38,216
Bam Adebayo,C,22,MIA,24,24,805,137,232,.591,1,8,.125,136,224,.607,.593,91,137,.664,61,192,253,105,34,28,72,64,366
LaMarcus Aldridge,C,34,SAS,21,21,691,161,314,.513,12,33,.364,149,281,.530,.532,62,74,.838,44,103,147,51,13,37,34,46,396
Nickeil Alexander-Walker,SG,21,NOP,20,0,281,46,141,.326,24,75,.320,22,66,.333,.411,11,16,.688,4,41,45,39,7,2,23,26,127
Grayson Allen,SG,24,MEM,13,0,246,38,92,.413,15,43,.349,23,49,.469,.495,15,17,.882,2,36,38,19,5,1,15,21,106
Jarrett Allen,C,21,BRK,23,20,610,112,169,.663,0,1,.000,112,168,.667,.663,60,100,.600,85,158,243,27,18,30,28,57,284
Kadeem Allen,SG,27,NYK,1,0,16,3,6,.500,3,4,.750,0,2,.000,.750,0,0,NA,0,0,0,2,1,0,1,1,9
Al-Farouq Aminu,PF,29,ORL,18,2,380,25,86,.291,9,36,.250,16,50,.320,.343,19,29,.655,24,63,87,21,18,8,17,27,78
Kyle Anderson,PF,26,MEM,17,0,348,47,93,.505,4,16,.250,43,77,.558,.527,16,28,.571,16,59,75,44,12,12,15,29,114
Ryan Anderson,PF,31,HOU,2,0,14,2,7,.286,1,5,.200,1,2,.500,.357,0,0,NA,0,7,7,2,1,0,1,1,5
Giannis Antetokounmpo,PF,25,MIL,24,24,758,275,488,.564,38,119,.319,237,369,.642,.602,153,260,.588,65,252,317,133,31,31,91,77,741
Kostas Antetokounmpo,PF,22,LAL,2,0,3,0,0,NA,0,0,NA,0,0,NA,NA,0,0,NA,0,1,1,0,0,0,0,0,0
Thanasis Antetokounmpo,SF,27,MIL,4,0,25,6,10,.600,0,0,NA,6,10,.600,.600,2,4,.500,3,0,3,4,0,0,2,3,14
Carmelo Anthony,PF,35,POR,11,11,343,65,160,.406,17,43,.395,48,117,.410,.459,28,35,.800,10,52,62,15,13,3,24,35,175
OG Anunoby,SF,22,TOR,22,22,658,98,188,.521,34,81,.420,64,107,.598,.612,16,29,.552,22,101,123,40,30,20,25,51,246
Ryan Arcidiacono,PG,25,CHI,25,0,393,32,88,.364,22,56,.393,10,32,.313,.489,15,20,.750,13,27,40,41,12,2,17,47,101
Trevor Ariza,SF,34,SAC,16,0,355,28,78,.359,21,60,.350,7,18,.389,.494,9,12,.750,7,54,61,19,16,3,12,27,86
D.J. Augustin,PG,32,ORL,23,5,589,74,195,.379,24,80,.300,50,115,.435,.441,52,59,.881,11,44,55,109,18,0,33,25,224
Deandre Ayton,C,21,PHO,1,1,33,9,14,.643,0,0,NA,9,14,.643,.643,0,0,NA,3,8,11,0,1,4,0,2,18
Dwayne Bacon,SG,24,CHO,19,10,375,49,153,.320,10,42,.238,39,111,.351,.353,20,29,.690,8,42,50,24,15,2,19,32,128
Marvin Bagley,PF,20,SAC,1,1,28,6,16,.375,0,0,NA,6,16,.375,.375,2,4,.500,4,6,10,0,1,1,1,1,14
Lonzo Ball,PG,22,NOP,16,12,461,63,165,.382,34,100,.340,29,65,.446,.485,10,14,.714,13,59,72,90,17,6,42,33,170
Mo Bamba,C,21,ORL,21,0,324,45,109,.413,15,41,.366,30,68,.441,.482,5,10,.500,27,81,108,9,6,30,26,46,110
J.J. Barea,PG,35,DAL,6,0,84,20,45,.444,10,17,.588,10,28,.357,.556,2,2,1.000,2,8,10,17,2,1,5,2,52
Harrison Barnes,PF,27,SAC,23,23,816,129,274,.471,31,86,.360,98,188,.521,.527,89,111,.802,26,96,122,53,21,5,37,29,378
RJ Barrett,SG,19,NYK,23,23,726,118,305,.387,22,73,.301,96,232,.414,.423,62,115,.539,26,95,121,72,30,11,54,55,320
Will Barton,SF,29,DEN,20,20,650,111,244,.455,38,94,.404,73,150,.487,.533,35,48,.729,31,100,131,69,21,9,26,42,295
Keita Bates-Diop,SF,24,MIN,12,0,230,35,67,.522,17,35,.486,18,32,.563,.649,6,10,.600,6,28,34,8,4,6,5,13,93
Nicolas Batum,SF,31,CHO,14,0,306,16,46,.348,9,33,.273,7,13,.538,.446,5,5,1.000,16,43,59,43,11,7,19,26,46
Aron Baynes,C,33,PHO,14,12,328,76,136,.559,27,64,.422,49,72,.681,.658,24,34,.706,20,58,78,39,4,10,15,55,203
Kent Bazemore,SF,30,POR,25,4,574,63,185,.341,31,90,.344,32,95,.337,.424,36,45,.800,10,96,106,40,22,18,35,74,193
Darius Bazley,PF,19,OKC,23,1,394,33,85,.388,15,42,.357,18,43,.419,.476,11,18,.611,8,79,87,12,8,10,18,22,92
Bradley Beal,SG,26,WAS,23,23,850,218,487,.448,58,176,.330,160,311,.514,.507,137,164,.835,24,80,104,162,21,6,81,62,631
Malik Beasley,SG,23,DEN,18,0,283,43,113,.381,22,54,.407,21,59,.356,.478,6,7,.857,5,21,26,18,8,2,17,19,114
Marco Belinelli,SG,33,SAS,21,0,340,39,124,.315,21,63,.333,18,61,.295,.399,15,21,.714,1,34,35,32,5,0,9,17,114
Jordan Bell,C,25,MIN,13,0,125,18,33,.545,0,5,.000,18,28,.643,.545,11,19,.579,13,33,46,8,0,6,14,10,47
DeAndre' Bembry,SG,25,ATL,24,4,601,73,150,.487,9,38,.237,64,112,.571,.517,18,37,.486,25,81,106,63,33,11,37,52,173
Dragan Bender,SF,22,MIL,3,0,29,6,8,.750,2,4,.500,4,4,1.000,.875,1,1,1.000,0,2,2,3,0,2,1,6,15
Dāvis Bertāns,PF,27,WAS,23,1,665,120,253,.474,92,198,.465,28,55,.509,.656,28,32,.875,22,86,108,36,14,14,14,58,360
Patrick Beverley,PG,31,LAC,23,23,688,65,164,.396,31,98,.316,34,66,.515,.491,14,23,.609,32,115,147,75,34,12,34,87,175
Khem Birch,C,27,ORL,14,9,319,23,47,.489,0,1,.000,23,46,.500,.489,13,26,.500,31,50,81,16,8,11,11,37,59
Goga Bitadze,C,20,IND,18,2,218,26,57,.456,4,14,.286,22,43,.512,.491,14,19,.737,16,36,52,14,1,19,10,33,70
Bismack Biyombo,C,27,CHO,24,9,404,71,124,.573,0,0,NA,71,124,.573,.573,44,75,.587,42,72,114,19,6,17,15,47,186
Nemanja Bjelica,PF,31,SAC,23,22,609,105,219,.479,43,101,.426,62,118,.525,.578,16,17,.941,45,111,156,62,24,13,39,69,269
Eric Bledsoe,PG,30,MIL,24,24,650,134,289,.464,27,86,.314,107,203,.527,.510,55,70,.786,21,100,121,137,19,12,55,57,350
Bogdan Bogdanović,SG,27,SAC,21,0,576,105,261,.402,55,146,.377,50,115,.435,.508,33,46,.717,6,53,59,89,26,2,37,38,298
Bojan Bogdanović,SF,30,UTA,23,23,761,160,351,.456,72,159,.453,88,192,.458,.558,81,92,.880,16,86,102,46,17,4,62,45,473
Jonah Bolden,PF,24,PHI,2,0,5,1,1,1.000,0,0,NA,1,1,1.000,1.000,0,2,.000,0,0,0,0,1,0,1,0,2
Jordan Bone,PG,22,DET,3,0,6,2,5,.400,0,1,.000,2,4,.500,.400,0,0,NA,0,0,0,0,0,0,2,2,4
Isaac Bonga,SF,20,WAS,18,12,279,25,52,.481,4,15,.267,21,37,.568,.519,10,13,.769,12,32,44,24,12,4,10,38,64
Devin Booker,SG,23,PHO,23,23,822,207,403,.514,54,130,.415,153,273,.560,.581,118,130,.908,14,75,89,144,14,8,90,71,586
Chris Boucher,PF,27,TOR,20,0,240,39,86,.453,10,31,.323,29,55,.527,.512,20,29,.690,40,45,85,10,7,15,8,27,108
Brian Bowen,SG,21,IND,3,0,10,1,4,.250,0,1,.000,1,3,.333,.250,0,0,NA,0,1,1,0,0,1,0,0,2
Ky Bowman,PG,22,GSW,25,6,580,87,192,.453,27,64,.422,60,128,.469,.523,19,20,.950,13,56,69,70,23,3,31,54,220
Avery Bradley,SG,29,LAL,10,10,274,41,84,.488,8,28,.286,33,56,.589,.536,6,8,.750,7,25,32,18,10,1,11,26,96
Tony Bradley,C,22,UTA,18,2,164,33,54,.611,0,0,NA,33,54,.611,.611,11,16,.688,25,38,63,5,2,8,8,28,77
Jarrell Brantley,PF,23,UTA,2,0,9,0,0,NA,0,0,NA,0,0,NA,NA,0,0,NA,0,4,4,1,0,2,1,1,0
Ignas Brazdeikis,SF,21,NYK,7,0,47,5,20,.250,1,8,.125,4,12,.333,.275,3,4,.750,2,3,5,2,0,1,2,3,14
Mikal Bridges,SF,23,PHO,23,0,485,61,122,.500,12,39,.308,49,83,.590,.549,33,42,.786,21,64,85,26,32,8,19,43,167
Miles Bridges,SF,21,CHO,26,26,803,130,289,.450,44,113,.389,86,176,.489,.526,31,40,.775,35,101,136,47,12,20,42,53,335
Oshae Brissett,SF,21,TOR,4,0,17,1,3,.333,1,1,1.000,0,2,.000,.500,0,0,NA,0,1,1,1,1,0,1,0,3
Ryan Broekhoff,SG,29,DAL,4,0,25,4,8,.500,4,5,.800,0,3,.000,.750,0,0,NA,0,5,5,3,1,0,1,1,12
Malcolm Brogdon,PG,27,IND,20,20,635,139,294,.473,30,87,.345,109,207,.527,.524,73,78,.936,12,81,93,149,19,4,58,42,381
Dillon Brooks,SG,24,MEM,23,23,632,111,280,.396,39,107,.364,72,173,.416,.466,44,55,.800,24,56,80,45,25,8,28,87,305
Bruce Brown,SG,23,DET,24,20,632,71,167,.425,13,39,.333,58,128,.453,.464,22,39,.564,21,82,103,86,22,12,43,64,177
Charlie Brown,SG,22,ATL,4,0,16,1,3,.333,1,1,1.000,0,2,.000,.500,4,4,1.000,2,1,3,0,0,1,0,0,7
Jaylen Brown,SF,23,BOS,19,19,634,144,287,.502,38,101,.376,106,186,.570,.568,54,74,.730,20,112,132,37,21,7,31,61,380
Moses Brown,C,20,POR,4,0,15,3,7,.429,0,0,NA,3,7,.429,.429,2,4,.500,2,7,9,0,1,0,1,4,8
Sterling Brown,SF,24,MIL,16,0,264,32,76,.421,16,41,.390,16,35,.457,.526,10,15,.667,11,65,76,23,10,2,16,22,90
Troy Brown,SG,20,WAS,20,11,442,60,133,.451,9,36,.250,51,97,.526,.485,19,25,.760,27,77,104,44,28,3,20,30,148
Jalen Brunson,PG,23,DAL,23,3,360,68,137,.496,14,43,.326,54,94,.574,.547,22,31,.710,13,41,54,59,11,0,20,26,172
Thomas Bryant,C,22,WAS,18,18,511,101,184,.549,10,35,.286,91,149,.611,.576,39,53,.736,42,111,153,48,8,18,24,44,251
Trey Burke,PG,27,PHI,9,0,152,25,58,.431,6,16,.375,19,42,.452,.483,8,11,.727,6,7,13,31,7,1,4,7,64
Alec Burks,SG,28,GSW,22,10,643,110,262,.420,32,90,.356,78,172,.453,.481,80,90,.889,15,84,99,65,24,6,32,48,332
Deonte Burton,SG,26,OKC,12,0,101,13,33,.394,5,17,.294,8,16,.500,.470,3,4,.750,3,18,21,4,1,1,4,11,34
Jimmy Butler,SF,30,MIA,20,20,702,119,276,.431,21,69,.304,98,207,.473,.469,153,185,.827,41,96,137,139,42,15,52,27,412
Bruno Caboclo,SF,24,MEM,15,0,160,26,59,.441,4,20,.200,22,39,.564,.475,2,3,.667,14,21,35,8,7,11,7,17,58
Kentavious Caldwell-Pope,SG,26,LAL,24,14,576,72,160,.450,27,71,.380,45,89,.506,.534,20,24,.833,11,40,51,42,18,4,20,40,191
Vlatko Čančar,SF,22,DEN,1,0,2,0,0,NA,0,0,NA,0,0,NA,NA,0,0,NA,0,0,0,0,0,0,0,0,0
Clint Capela,C,25,HOU,19,19,620,122,189,.646,0,0,NA,122,189,.646,.646,28,60,.467,82,199,281,19,16,35,34,55,272
DeMarre Carroll,SF,33,SAS,11,0,120,7,25,.280,3,12,.250,4,13,.308,.340,10,14,.714,7,22,29,10,2,2,9,17,27
Jevon Carter,PG,24,PHO,16,2,225,22,55,.400,14,34,.412,8,21,.381,.527,4,4,1.000,3,24,27,28,13,5,15,24,62
Vince Carter,SF,43,ATL,19,0,301,42,112,.375,22,77,.286,20,35,.571,.473,6,8,.750,4,33,37,18,6,6,13,33,112
Wendell Carter,C,20,CHI,25,25,749,117,206,.568,2,15,.133,115,191,.602,.573,69,98,.704,88,157,245,24,18,20,38,103,305
Michael Carter-Williams,SG,28,ORL,13,0,197,18,57,.316,3,19,.158,15,38,.395,.342,19,23,.826,14,28,42,22,12,6,13,19,58
Alex Caruso,PG,25,LAL,22,0,454,48,107,.449,16,46,.348,32,61,.525,.523,13,20,.650,3,42,45,44,24,7,23,36,125
Willie Cauley-Stein,C,26,GSW,22,21,493,78,140,.557,0,0,NA,78,140,.557,.557,21,31,.677,33,111,144,35,23,27,21,63,177
Tyson Chandler,C,37,HOU,18,4,163,13,17,.765,0,0,NA,13,17,.765,.765,5,9,.556,19,30,49,6,5,7,6,24,31
Zylan Cheatham,SF,24,NOP,2,0,20,1,4,.250,0,1,.000,1,3,.333,.250,0,0,NA,0,3,3,1,0,0,1,3,2
Chris Chiozza,PG,24,WAS,9,0,104,7,28,.250,5,11,.455,2,17,.118,.339,0,0,NA,0,11,11,26,8,2,7,10,19
Marquese Chriss,PF,22,GSW,24,1,425,61,129,.473,4,19,.211,57,110,.518,.488,43,50,.860,33,79,112,46,17,22,35,48,169
Gary Clark,PF,25,HOU,8,0,93,11,28,.393,8,23,.348,3,5,.600,.536,2,2,1.000,6,14,20,5,1,3,1,9,32
Brandon Clarke,PF,23,MEM,18,2,381,92,146,.630,10,22,.455,82,124,.661,.664,19,23,.826,24,82,106,23,9,17,19,31,213
Jordan Clarkson,SG,27,CLE,23,0,510,104,250,.416,41,118,.347,63,132,.477,.498,67,75,.893,14,37,51,56,12,6,32,26,316
Nicolas Claxton,PF,20,BRK,9,0,119,11,21,.524,0,5,.000,11,16,.688,.524,5,12,.417,8,14,22,11,1,5,6,10,27
Chris Clemons,SG,22,HOU,16,0,134,24,59,.407,18,47,.383,6,12,.500,.559,3,4,.750,2,8,10,6,3,2,6,14,69
John Collins,PF,22,ATL,5,5,161,32,61,.525,9,19,.474,23,42,.548,.598,12,17,.706,10,34,44,8,5,10,7,17,85
Zach Collins,PF,22,POR,3,3,86,9,19,.474,3,7,.429,6,12,.500,.553,6,6,1.000,4,8,12,6,0,2,6,11,27
Mike Conley,PG,32,UTA,21,21,628,97,263,.369,40,107,.374,57,156,.365,.445,58,73,.795,16,57,73,96,15,4,44,45,292
Pat Connaughton,SG,27,MIL,22,0,393,47,96,.490,18,54,.333,29,42,.690,.583,13,17,.765,11,78,89,42,8,11,13,23,125
Quinn Cook,PG,26,LAL,20,0,267,42,98,.429,12,35,.343,30,63,.476,.490,4,5,.800,4,19,23,30,6,1,16,12,100
Tyler Cook,PF,22,CLE,6,0,17,5,6,.833,0,0,NA,5,6,.833,.833,2,2,1.000,3,2,5,0,1,0,1,1,12
Robert Covington,PF,29,MIN,22,22,611,92,202,.455,45,122,.369,47,80,.588,.567,46,51,.902,17,99,116,24,29,19,34,66,275
Allen Crabbe,SG,27,ATL,12,1,234,26,65,.400,12,40,.300,14,25,.560,.492,7,9,.778,5,25,30,12,8,3,5,11,71
Torrey Craig,SF,29,DEN,15,2,200,16,43,.372,4,20,.200,12,23,.522,.419,4,9,.444,9,26,35,15,5,12,6,28,40
Jae Crowder,SF,29,MEM,23,23,713,80,207,.386,48,150,.320,32,57,.561,.502,34,46,.739,16,121,137,62,22,8,32,48,242
Jarrett Culver,SG,20,MIN,23,13,543,83,216,.384,23,87,.264,60,129,.465,.438,23,51,.451,24,54,78,54,21,12,31,49,212
Seth Curry,SG,29,DAL,21,9,445,56,130,.431,31,81,.383,25,49,.510,.550,29,31,.935,8,32,40,34,12,4,16,38,172
Stephen Curry,PG,31,GSW,4,4,112,27,66,.409,9,37,.243,18,29,.621,.477,18,18,1.000,4,16,20,26,5,2,15,10,81
Troy Daniels,SG,28,LAL,19,0,271,33,90,.367,23,68,.338,10,22,.455,.494,3,4,.750,4,23,27,7,7,1,6,14,92
Anthony Davis,PF,26,LAL,23,23,791,222,438,.507,25,75,.333,197,363,.543,.535,167,192,.870,56,152,208,75,35,61,52,53,636
Ed Davis,C,30,UTA,12,0,147,9,20,.450,0,0,NA,9,20,.450,.450,3,6,.500,14,40,54,5,5,6,9,28,21
Terence Davis,SG,22,TOR,23,0,360,55,113,.487,25,60,.417,30,53,.566,.597,14,15,.933,14,54,68,43,10,6,18,42,149
Dewayne Dedmon,C,30,SAC,21,4,305,42,103,.408,11,48,.229,31,55,.564,.461,11,13,.846,26,59,85,8,9,11,31,55,106
Matthew Dellavedova,PG,29,CLE,21,0,275,18,65,.277,4,37,.108,14,28,.500,.308,12,13,.923,6,23,29,46,8,1,15,30,52
DeMar DeRozan,SF,30,SAS,23,23,787,189,372,.508,5,14,.357,184,358,.514,.515,109,134,.813,12,118,130,111,22,11,59,66,492
Cheick Diallo,C,23,PHO,17,0,174,41,59,.695,1,1,1.000,40,58,.690,.703,15,17,.882,14,38,52,9,2,4,8,20,98
Hamidou Diallo,SF,21,OKC,12,1,256,46,92,.500,2,13,.154,44,79,.557,.511,11,18,.611,14,32,46,10,18,4,14,29,105
Gorgui Dieng,C,30,MIN,19,2,237,34,79,.430,8,27,.296,26,52,.500,.481,12,16,.750,16,60,76,20,13,20,13,26,88
Spencer Dinwiddie,SG,26,BRK,23,12,684,156,366,.426,43,138,.312,113,228,.496,.485,119,140,.850,5,62,67,142,20,11,62,79,474
Donte DiVincenzo,SG,23,MIL,21,10,441,69,160,.431,28,79,.354,41,81,.506,.519,20,26,.769,18,70,88,32,32,3,23,35,186
Luka Dončić,PG,20,DAL,23,23,769,222,466,.476,70,219,.320,152,247,.615,.552,175,215,.814,31,195,226,211,30,3,105,55,689
Luguentz Dort,SG,20,OKC,3,0,56,4,11,.364,0,6,.000,4,5,.800,.364,3,5,.600,0,6,6,0,1,0,2,10,11
Damyean Dotson,SG,25,NYK,20,0,320,47,115,.409,21,68,.309,26,47,.553,.500,10,13,.769,4,30,34,19,9,4,11,18,125
Sekou Doumbouya,SF,19,DET,4,0,11,3,6,.500,0,1,.000,3,5,.600,.500,0,1,.000,0,2,2,0,0,0,0,3,6
Goran Dragić,PG,33,MIA,18,1,517,97,208,.466,39,96,.406,58,112,.518,.560,54,76,.711,6,52,58,90,12,4,47,32,287
Andre Drummond,C,26,DET,24,24,811,175,325,.538,0,12,.000,175,313,.559,.538,69,108,.639,113,288,401,72,40,45,87,92,419
Jared Dudley,SF,34,LAL,15,0,100,5,11,.455,5,8,.625,0,3,.000,.682,2,2,1.000,2,10,12,9,5,1,2,8,17
Kris Dunn,PG,25,CHI,25,6,542,72,171,.421,11,57,.193,61,114,.535,.453,13,18,.722,14,66,80,73,48,7,26,89,168
Carsen Edwards,SG,21,BOS,20,0,228,26,82,.317,16,49,.327,10,33,.303,.415,11,13,.846,5,30,35,17,7,2,12,22,79
Henry Ellenson,PF,23,BRK,1,0,3,0,0,NA,0,0,NA,0,0,NA,NA,0,0,NA,0,0,0,0,0,0,0,0,0
Wayne Ellington,SG,32,NYK,18,1,257,26,81,.321,21,69,.304,5,12,.417,.451,4,6,.667,1,28,29,16,5,2,12,20,77
Joel Embiid,C,25,PHI,20,20,608,141,308,.458,21,70,.300,120,238,.504,.492,136,168,.810,50,197,247,62,19,27,68,69,439
James Ennis,SF,29,PHI,25,0,438,63,126,.500,23,55,.418,40,71,.563,.591,36,46,.783,28,58,86,22,13,7,15,48,185
Drew Eubanks,PF,22,SAS,4,0,31,5,10,.500,0,0,NA,5,10,.500,.500,1,1,1.000,5,8,13,2,0,1,4,4,11
Jacob Evans,SG,22,GSW,4,0,54,6,16,.375,4,8,.500,2,8,.250,.500,4,4,1.000,1,5,6,3,0,0,2,4,20
Dante Exum,SG,24,UTA,11,0,83,10,23,.435,2,6,.333,8,17,.471,.478,2,2,1.000,3,9,12,7,1,2,10,8,24
Tacko Fall,C,24,BOS,1,0,4,2,4,.500,0,0,NA,2,4,.500,.500,0,0,NA,0,3,3,0,0,0,1,2,4
Derrick Favors,C,28,NOP,9,7,189,36,58,.621,1,2,.500,35,56,.625,.629,2,6,.333,31,49,80,19,5,4,14,21,75
Terrance Ferguson,SF,21,OKC,19,19,497,39,92,.424,23,65,.354,16,27,.593,.549,7,9,.778,11,25,36,19,10,6,14,57,108
Bruno Fernando,C,21,ATL,24,0,283,40,74,.541,4,16,.250,36,58,.621,.568,13,22,.591,27,42,69,25,5,9,22,37,97
Yogi Ferrell,PG,26,SAC,19,0,265,40,89,.449,9,30,.300,31,59,.525,.500,25,29,.862,4,21,25,35,8,1,13,17,114
Dorian Finney-Smith,PF,26,DAL,23,20,618,73,155,.471,28,85,.329,45,70,.643,.561,24,34,.706,43,73,116,25,14,10,24,43,198
Bryn Forbes,SG,26,SAS,23,23,619,105,251,.418,55,152,.362,50,99,.505,.528,31,37,.838,7,50,57,46,12,0,16,44,296
Evan Fournier,SG,27,ORL,23,23,707,159,329,.483,64,143,.448,95,186,.511,.581,78,92,.848,4,64,68,73,22,4,47,53,460
De'Aaron Fox,PG,22,SAC,9,9,288,55,128,.430,10,30,.333,45,98,.459,.469,44,62,.710,5,31,36,63,7,5,37,27,164
Melvin Frazier,SG,23,ORL,4,0,11,1,6,.167,0,1,.000,1,5,.200,.167,0,0,NA,1,0,1,1,0,0,0,1,2
Tim Frazier,PG,29,DET,13,4,138,9,42,.214,3,14,.214,6,28,.214,.250,11,14,.786,4,9,13,38,8,2,12,18,32
Markelle Fultz,PG,21,ORL,23,18,593,113,236,.479,8,38,.211,105,198,.530,.496,42,53,.792,10,53,63,94,29,4,42,49,276
Wenyen Gabriel,PF,22,SAC,7,0,47,5,16,.313,1,8,.125,4,8,.500,.344,5,9,.556,4,4,8,3,2,2,3,6,16
Daniel Gafford,C,21,CHI,16,0,169,32,43,.744,0,0,NA,32,43,.744,.744,10,21,.476,14,15,29,2,1,14,2,23,74
Danilo Gallinari,PF,31,OKC,22,22,668,123,276,.446,60,149,.403,63,127,.496,.554,96,105,.914,12,114,126,46,15,3,31,35,402
Langston Galloway,SG,28,DET,24,6,662,96,213,.451,61,142,.430,35,71,.493,.594,45,50,.900,9,42,51,37,14,7,19,30,298
Darius Garland,PG,20,CLE,23,23,648,95,253,.375,37,103,.359,58,150,.387,.449,23,27,.852,8,34,42,65,16,0,57,33,250
Marc Gasol,C,35,TOR,23,23,662,49,144,.340,27,77,.351,22,67,.328,.434,19,24,.792,17,129,146,81,15,27,31,77,144
Rudy Gay,PF,33,SAS,23,4,532,96,209,.459,20,73,.274,76,136,.559,.507,48,54,.889,31,105,136,44,10,13,38,34,260
Paul George,SF,29,LAC,14,14,416,108,242,.446,57,136,.419,51,106,.481,.564,62,68,.912,7,82,89,50,20,6,48,36,335
Taj Gibson,C,34,NYK,22,16,360,50,98,.510,2,10,.200,48,88,.545,.520,9,15,.600,42,55,97,27,15,5,16,49,111
Harry Giles,PF,21,SAC,7,0,52,11,25,.440,0,0,NA,11,25,.440,.440,2,2,1.000,3,4,7,5,2,3,5,13,24
Shai Gilgeous-Alexander,SG,21,OKC,23,23,802,156,361,.432,34,95,.358,122,266,.459,.479,86,108,.796,16,103,119,69,23,10,49,42,432
Rudy Gobert,C,27,UTA,22,22,745,121,178,.680,0,0,NA,121,178,.680,.680,75,122,.615,74,224,298,30,17,39,49,70,317
Brandon Goodwin,PG,24,ATL,2,0,5,0,1,.000,0,1,.000,0,0,NA,.000,0,0,NA,0,0,0,0,0,0,2,1,0
Aaron Gordon,PF,24,ORL,20,20,623,100,236,.424,25,80,.313,75,156,.481,.477,48,67,.716,31,105,136,57,14,10,28,43,273
Eric Gordon,SG,31,HOU,9,2,265,34,110,.309,21,74,.284,13,36,.361,.405,9,14,.643,3,14,17,7,5,2,12,21,98
Devonte' Graham,PG,24,CHO,26,16,876,162,398,.407,96,228,.421,66,170,.388,.528,80,99,.808,27,68,95,200,19,6,78,46,500
Treveon Graham,SG,26,MIN,22,17,484,47,136,.346,13,62,.210,34,74,.459,.393,19,24,.792,23,53,76,23,14,2,13,49,126
Jerami Grant,PF,25,DEN,22,0,483,75,169,.444,27,75,.360,48,94,.511,.524,25,42,.595,11,63,74,24,9,14,18,41,202
Josh Gray,PG,26,NOP,2,0,23,1,2,.500,0,0,NA,1,2,.500,.500,0,0,NA,1,1,2,2,0,0,5,1,2
Danny Green,SG,32,LAL,24,24,607,71,164,.433,47,118,.398,24,46,.522,.576,8,11,.727,15,76,91,29,31,12,23,58,197
Draymond Green,PF,29,GSW,16,16,451,51,126,.405,11,40,.275,40,86,.465,.448,28,39,.718,7,88,95,89,25,11,37,42,141
JaMychal Green,PF,29,LAC,22,0,469,55,133,.414,34,90,.378,21,43,.488,.541,18,21,.857,29,116,145,10,13,7,20,54,162
Javonte Green,SF,26,BOS,16,0,111,21,35,.600,3,10,.300,18,25,.720,.643,2,5,.400,3,12,15,4,4,2,3,11,47
Jeff Green,PF,33,UTA,24,2,456,63,158,.399,30,86,.349,33,72,.458,.494,43,54,.796,10,56,66,15,10,10,25,42,199
Blake Griffin,PF,30,DET,12,12,352,69,173,.399,22,71,.310,47,102,.461,.462,58,75,.773,12,47,59,39,5,4,33,17,218
Marko Guduric,SG,24,MEM,23,0,347,45,116,.388,17,57,.298,28,59,.475,.461,13,15,.867,11,36,47,33,8,5,24,22,120
Rui Hachimura,PF,21,WAS,23,23,684,139,289,.481,9,45,.200,130,244,.533,.497,44,51,.863,38,101,139,40,18,3,19,54,331
Devon Hall,SG,24,OKC,5,0,20,1,5,.200,0,2,.000,1,3,.333,.200,3,4,.750,0,1,1,3,0,0,1,1,5
Tim Hardaway,SG,27,DAL,23,10,570,103,238,.433,56,147,.381,47,91,.516,.550,41,50,.820,7,42,49,41,14,3,12,44,303
James Harden,SG,30,HOU,23,23,868,238,552,.431,107,317,.338,131,235,.557,.528,290,330,.879,22,117,139,172,46,13,117,75,873
Maurice Harkless,SF,26,LAC,25,15,580,57,118,.483,15,41,.366,42,77,.545,.547,13,26,.500,24,63,87,28,26,19,21,71,142
Jared Harper,PG,22,PHO,1,0,2,0,1,.000,0,1,.000,0,0,NA,.000,0,0,NA,0,0,0,0,0,0,0,0,0
Montrezl Harrell,C,26,LAC,25,2,733,198,332,.596,0,9,.000,198,323,.613,.596,81,132,.614,73,123,196,51,19,29,41,58,477
Gary Harris,SG,25,DEN,22,22,702,89,215,.414,33,92,.359,56,123,.455,.491,25,32,.781,11,56,67,44,26,7,21,47,236
Joe Harris,SF,28,BRK,23,23,728,126,261,.483,66,145,.455,60,116,.517,.609,22,27,.815,20,67,87,48,17,8,31,57,340
Tobias Harris,PF,27,PHI,25,25,856,189,390,.485,36,111,.324,153,279,.548,.531,67,84,.798,18,157,175,79,23,20,51,67,481
Shaquille Harrison,SF,26,CHI,15,4,133,18,45,.400,3,9,.333,15,36,.417,.433,11,18,.611,5,22,27,19,6,4,6,16,50
Josh Hart,SF,24,NOP,17,4,464,64,153,.418,37,106,.349,27,47,.574,.539,26,34,.765,18,87,105,25,17,6,21,46,191
Isaiah Hartenstein,C,21,HOU,8,0,96,11,15,.733,0,1,.000,11,14,.786,.733,9,11,.818,8,18,26,4,2,4,6,16,31
Udonis Haslem,PF,39,MIA,2,0,11,1,1,1.000,0,0,NA,1,1,1.000,1.000,3,4,.750,0,3,3,0,0,0,0,3,5
Jaxson Hayes,C,19,NOP,21,10,442,72,118,.610,0,3,.000,72,115,.626,.610,46,70,.657,43,54,97,14,17,23,18,67,190
Gordon Hayward,SF,29,BOS,9,9,276,68,120,.567,13,32,.406,55,88,.625,.621,16,19,.842,7,55,62,37,7,2,17,16,165
John Henson,PF,29,CLE,5,0,59,11,21,.524,0,5,.000,11,16,.688,.524,3,9,.333,6,8,14,5,4,6,5,5,25
Dewan Hernandez,C,23,TOR,3,0,9,1,5,.200,0,1,.000,1,4,.250,.200,2,2,1.000,2,5,7,0,1,0,1,5,4
Juan Hernangómez,PF,24,DEN,15,0,210,21,57,.368,12,37,.324,9,20,.450,.474,5,9,.556,8,28,36,11,1,3,9,14,59
Willy Hernangómez,C,25,CHO,8,0,60,9,22,.409,2,6,.333,7,16,.438,.455,4,8,.500,9,12,21,2,1,3,5,4,24
Tyler Herro,SG,20,MIA,23,3,660,117,267,.438,47,124,.379,70,143,.490,.526,39,47,.830,6,83,89,45,18,3,46,32,320
Mario Hezonja,PF,24,POR,22,4,384,35,97,.361,10,31,.323,25,66,.379,.412,22,27,.815,16,86,102,22,13,2,20,50,102
Buddy Hield,SG,27,SAC,23,23,788,179,423,.423,89,239,.372,90,184,.489,.528,46,54,.852,22,88,110,62,19,9,59,60,493
George Hill,PG,33,MIL,22,0,465,72,133,.541,33,64,.516,39,69,.565,.665,31,37,.838,22,42,64,69,17,2,18,37,208
Solomon Hill,SF,28,MEM,21,1,426,48,114,.421,24,62,.387,24,52,.462,.526,11,18,.611,11,57,68,40,23,2,19,34,131
Jaylen Hoard,SF,20,POR,5,0,18,3,6,.500,0,0,NA,3,6,.500,.500,1,2,.500,3,4,7,2,1,0,0,1,7
Aaron Holiday,PG,23,IND,22,9,462,73,187,.390,32,84,.381,41,103,.398,.476,13,14,.929,9,47,56,61,18,2,30,32,191
Jrue Holiday,SG,29,NOP,22,22,789,173,385,.449,37,114,.325,136,271,.502,.497,41,61,.672,28,82,110,146,43,15,71,56,424
Justin Holiday,SG,30,IND,24,2,602,63,153,.412,38,96,.396,25,57,.439,.536,19,23,.826,11,79,90,38,24,16,15,41,183
Rondae Hollis-Jefferson,SF,25,TOR,16,0,331,57,104,.548,1,5,.200,56,99,.566,.553,27,37,.730,39,47,86,23,12,6,20,28,142
Richaun Holmes,C,26,SAC,23,19,673,121,181,.669,0,0,NA,121,181,.669,.669,46,58,.793,66,132,198,24,24,32,21,93,288
Rodney Hood,SF,27,POR,21,21,619,87,172,.506,35,71,.493,52,101,.515,.608,21,27,.778,10,62,72,32,17,4,19,46,230
Al Horford,C,33,PHI,23,23,708,129,269,.480,34,93,.366,95,176,.540,.543,25,37,.676,40,117,157,89,26,23,28,54,317
Talen Horton-Tucker,SG,19,LAL,1,0,2,0,1,.000,0,1,.000,0,0,NA,.000,0,0,NA,0,0,0,1,0,0,0,0,0
Danuel House,SF,26,HOU,17,15,507,66,145,.455,43,101,.426,23,44,.523,.603,30,37,.811,18,53,71,24,19,11,16,39,205
Dwight Howard,C,34,LAL,24,0,480,66,89,.742,1,3,.333,65,86,.756,.747,35,67,.522,50,119,169,18,9,33,26,89,168
Kevin Huerter,SG,21,ATL,13,5,290,38,91,.418,23,59,.390,15,32,.469,.544,12,15,.800,7,33,40,43,9,6,17,24,111
De'Andre Hunter,SF,22,ATL,23,22,733,105,256,.410,42,115,.365,63,141,.447,.492,42,55,.764,11,82,93,44,14,6,39,60,294
Chandler Hutchison,SF,23,CHI,9,6,154,20,44,.455,5,12,.417,15,32,.469,.511,19,29,.655,1,32,33,8,5,2,12,12,64
Serge Ibaka,C,30,TOR,13,0,289,65,142,.458,12,32,.375,53,110,.482,.500,29,35,.829,23,68,91,15,6,11,29,35,171
Ersan İlyasova,PF,32,MIL,22,0,347,58,119,.487,17,54,.315,41,65,.631,.559,27,33,.818,29,75,104,13,10,7,6,38,160
Joe Ingles,SF,32,UTA,24,4,668,60,164,.366,35,108,.324,25,56,.446,.473,24,32,.750,5,92,97,97,24,2,41,55,179
Brandon Ingram,PF,22,NOP,20,20,674,179,362,.494,46,110,.418,133,252,.528,.558,94,112,.839,15,124,139,79,16,18,58,60,498
Kyrie Irving,PG,27,BRK,11,11,372,112,252,.444,31,91,.341,81,161,.503,.506,59,63,.937,10,49,59,79,12,6,26,32,314
Jonathan Isaac,SF,22,ORL,21,21,647,101,225,.449,24,74,.324,77,151,.510,.502,33,42,.786,38,115,153,30,27,60,34,49,259
Wesley Iwundu,SF,25,ORL,11,3,161,10,35,.286,1,9,.111,9,26,.346,.300,15,18,.833,4,19,23,9,5,3,4,9,36
Frank Jackson,PG,21,NOP,21,1,320,52,140,.371,20,65,.308,32,75,.427,.443,26,32,.813,5,25,30,22,9,1,21,32,150
Jaren Jackson,C,20,MEM,22,22,596,129,286,.451,46,124,.371,83,162,.512,.531,52,65,.800,27,78,105,31,12,27,42,91,356
Justin Jackson,PF,24,DAL,22,0,310,54,116,.466,23,58,.397,31,58,.534,.565,10,13,.769,9,46,55,9,5,2,4,23,141
Reggie Jackson,PG,29,DET,2,2,36,4,11,.364,1,5,.200,3,6,.500,.409,1,1,1.000,1,4,5,8,0,0,1,2,10
Justin James,SG,23,SAC,11,0,140,18,44,.409,3,14,.214,15,30,.500,.443,1,6,.167,2,18,20,9,4,6,5,11,40
LeBron James,PG,35,LAL,24,24,825,239,477,.501,52,143,.364,187,334,.560,.556,91,129,.705,23,141,164,259,31,13,89,42,621
Amile Jefferson,PF,26,ORL,5,0,13,3,3,1.000,0,0,NA,3,3,1.000,1.000,0,0,NA,2,2,4,2,0,0,1,2,6
DaQuan Jeffries,SG,22,SAC,2,0,11,1,1,1.000,0,0,NA,1,1,1.000,1.000,0,0,NA,1,0,1,1,0,0,0,1,2
Ty Jerome,PG,22,PHO,5,0,67,6,18,.333,3,7,.429,3,11,.273,.417,2,2,1.000,0,8,8,12,8,0,6,9,17
Alize Johnson,SF,23,IND,8,0,37,5,11,.455,0,0,NA,5,11,.455,.455,3,4,.750,6,6,12,2,0,0,1,4,13
B.J. Johnson,SF,24,ORL,1,0,3,0,0,NA,0,0,NA,0,0,NA,NA,0,0,NA,0,0,0,0,0,0,0,0,0
Cameron Johnson,PF,23,PHO,21,0,421,67,153,.438,42,103,.408,25,50,.500,.575,16,17,.941,21,43,64,18,12,7,14,37,192
James Johnson,PF,32,MIA,6,0,68,8,18,.444,2,9,.222,6,9,.667,.500,2,4,.500,2,9,11,4,3,2,4,5,20
Keldon Johnson,SF,20,SAS,1,0,2,0,1,.000,0,0,NA,0,1,.000,.000,0,0,NA,0,0,0,0,0,0,0,0,0
Stanley Johnson,PF,23,TOR,5,0,19,3,9,.333,1,4,.250,2,5,.400,.389,0,0,NA,2,5,7,0,1,0,4,6,7
Tyler Johnson,SG,27,PHO,19,3,364,44,111,.396,18,55,.327,26,56,.464,.477,18,24,.750,5,30,35,41,6,6,19,28,124
Nikola Jokić,C,24,DEN,22,22,683,145,310,.468,20,87,.230,125,223,.561,.500,43,54,.796,45,174,219,139,23,13,56,70,353
Damian Jones,C,24,ATL,23,15,432,69,99,.697,2,5,.400,67,94,.713,.707,30,45,.667,37,56,93,17,11,21,15,82,170
Derrick Jones,SF,22,MIA,10,0,167,20,43,.465,2,12,.167,18,31,.581,.488,8,13,.615,6,21,27,9,8,3,6,22,50
Tyus Jones,PG,23,MEM,23,5,469,57,149,.383,8,37,.216,49,112,.438,.409,18,25,.720,0,35,35,112,20,3,30,21,140
DeAndre Jordan,C,31,BRK,20,3,429,67,95,.705,0,0,NA,67,95,.705,.705,29,43,.674,45,139,184,41,8,21,21,42,163
Cory Joseph,PG,28,SAC,23,14,606,54,148,.365,12,44,.273,42,104,.404,.405,16,16,1.000,12,47,59,91,20,12,30,48,136
Mfiondu Kabengele,C,22,LAC,8,0,35,7,18,.389,4,10,.400,3,8,.375,.500,3,3,1.000,1,5,6,1,1,1,1,3,21
Frank Kaminsky,C,26,PHO,23,10,541,85,199,.427,26,82,.317,59,117,.504,.492,45,67,.672,24,97,121,50,9,9,24,52,241
Enes Kanter,C,27,BOS,15,3,239,43,73,.589,0,1,.000,43,72,.597,.589,24,37,.649,37,50,87,17,9,6,12,19,110
Luke Kennard,SG,23,DET,23,20,754,128,286,.448,59,148,.399,69,138,.500,.551,60,67,.896,6,73,79,96,11,5,33,54,375
Stanton Kidd,SF,27,UTA,4,0,15,0,3,.000,0,1,.000,0,2,.000,.000,0,0,NA,0,3,3,1,0,0,2,3,0
Michael Kidd-Gilchrist,PF,26,CHO,4,0,56,7,23,.304,2,8,.250,5,15,.333,.348,2,3,.667,4,8,12,3,0,1,3,8,18
Maxi Kleber,C,28,DAL,22,5,534,59,140,.421,31,84,.369,28,56,.500,.532,28,31,.903,37,89,126,22,5,14,15,40,177
Brandon Knight,PG,28,CLE,8,0,95,14,40,.350,10,31,.323,4,9,.444,.475,2,6,.333,1,7,8,15,4,0,6,9,40
Kevin Knox,SF,20,NYK,23,3,458,57,156,.365,30,86,.349,27,70,.386,.462,31,47,.660,10,56,66,29,11,8,16,37,175
John Konchar,SG,23,MEM,1,0,7,0,0,NA,0,0,NA,0,0,NA,NA,0,0,NA,0,0,0,0,0,0,0,0,0
Furkan Korkmaz,SG,22,PHI,24,11,540,73,172,.424,40,109,.367,33,63,.524,.541,17,21,.810,4,52,56,23,8,5,18,37,203
Luke Kornet,C,24,CHI,13,0,135,15,46,.326,5,26,.192,10,20,.500,.380,5,5,1.000,5,15,20,6,2,10,3,12,40
Kyle Korver,SF,38,MIL,20,0,308,34,94,.362,29,79,.367,5,15,.333,.516,9,11,.818,6,26,32,15,8,4,17,20,106
Rodions Kurucs,PF,21,BRK,10,0,99,9,23,.391,3,7,.429,6,16,.375,.457,2,6,.333,5,17,22,1,5,0,12,16,23
Kyle Kuzma,PF,24,LAL,20,1,461,81,187,.433,32,89,.360,49,98,.500,.519,27,39,.692,8,60,68,17,6,8,35,34,221
Skal Labissière,C,23,POR,25,0,419,62,111,.559,2,9,.222,60,102,.588,.568,15,22,.682,49,78,127,27,6,24,24,65,141
Jeremy Lamb,SG,27,IND,15,15,485,91,193,.472,19,62,.306,72,131,.550,.521,35,44,.795,10,69,79,39,17,8,21,33,236
Romeo Langford,SG,20,BOS,1,0,0,0,0,NA,0,0,NA,0,0,NA,NA,0,0,NA,0,0,0,0,0,0,0,0,0
Zach LaVine,SG,24,CHI,25,25,819,189,445,.425,74,187,.396,115,258,.446,.508,104,130,.800,17,95,112,100,31,12,85,62,556
Jake Layman,PF,25,MIN,14,2,369,61,132,.462,19,54,.352,42,78,.538,.534,6,10,.600,12,29,41,11,12,10,18,31,147
T.J. Leaf,PF,22,IND,15,1,158,26,58,.448,5,11,.455,21,47,.447,.491,5,8,.625,20,37,57,6,7,3,6,14,62
Courtney Lee,SG,34,DAL,7,3,62,13,22,.591,7,12,.583,6,10,.600,.750,0,0,NA,0,3,3,3,0,2,1,5,33
Damion Lee,SG,27,GSW,11,0,241,35,91,.385,12,35,.343,23,56,.411,.451,28,33,.848,9,34,43,20,8,0,13,18,110
Alex Len,C,26,ATL,23,9,393,70,135,.519,6,29,.207,64,106,.604,.541,30,43,.698,32,74,106,21,13,19,21,49,176
Kawhi Leonard,SF,28,LAC,18,18,560,161,360,.447,30,91,.330,131,269,.487,.489,99,116,.853,19,123,142,94,34,14,61,36,451
Meyers Leonard,PF,27,MIA,24,24,436,55,95,.579,21,42,.500,34,53,.642,.689,5,9,.556,8,94,102,23,7,11,18,49,136
Caris LeVert,SG,25,BRK,9,9,284,59,140,.421,13,36,.361,46,104,.442,.468,20,31,.645,10,35,45,36,6,1,31,20,151
Damian Lillard,PG,29,POR,23,23,841,191,426,.448,77,209,.368,114,217,.525,.539,159,174,.914,11,93,104,169,23,10,66,47,618
Nassir Little,PF,19,POR,18,3,270,31,76,.408,5,30,.167,26,46,.565,.441,15,22,.682,20,42,62,12,8,7,9,35,82
Kevon Looney,C,23,GSW,5,2,56,6,18,.333,1,1,1.000,5,17,.294,.361,2,4,.500,9,9,18,2,1,2,4,9,15
Brook Lopez,C,31,MIL,22,22,580,75,190,.395,32,109,.294,43,81,.531,.479,41,44,.932,12,94,106,30,16,52,22,47,223
Robin Lopez,C,31,MIL,24,2,346,48,102,.471,13,42,.310,35,60,.583,.534,10,17,.588,26,40,66,17,4,16,29,42,119
Kevin Love,PF,31,CLE,19,19,574,91,212,.429,40,112,.357,51,100,.510,.524,75,85,.882,18,181,199,50,12,7,52,26,297
Kyle Lowry,PG,33,TOR,12,12,448,71,168,.423,37,100,.370,34,68,.500,.533,63,70,.900,7,51,58,83,13,5,38,35,242
Timothé Luwawu-Cabarrot,SG,24,BRK,2,0,6,0,2,.000,0,1,.000,0,1,.000,.000,1,2,.500,0,0,0,0,0,0,0,0,1
Trey Lyles,PF,24,SAS,23,14,397,38,88,.432,18,48,.375,20,40,.500,.534,5,9,.556,32,108,140,29,7,7,18,27,99
Daryl Macon,SG,24,MIA,4,0,14,1,3,.333,1,2,.500,0,1,.000,.500,0,0,NA,0,0,0,1,0,0,2,1,3
Josh Magette,PG,30,ORL,3,0,10,2,6,.333,0,0,NA,2,6,.333,.333,1,2,.500,1,2,3,2,2,0,3,0,5
Ian Mahinmi,C,33,WAS,3,0,51,9,14,.643,0,1,.000,9,13,.692,.643,7,10,.700,6,8,14,2,1,5,4,8,25
Thon Maker,C,22,DET,22,0,230,23,43,.535,7,14,.500,16,29,.552,.616,16,31,.516,10,27,37,9,6,14,11,31,69
Terance Mann,SG,23,LAC,19,3,166,19,39,.487,2,9,.222,17,30,.567,.513,7,8,.875,3,19,22,22,6,2,12,21,47
Boban Marjanović,C,31,DAL,10,1,131,31,56,.554,0,1,.000,31,55,.564,.554,13,16,.813,15,40,55,7,2,3,9,18,75
Lauri Markkanen,PF,22,CHI,25,25,754,112,296,.378,49,153,.320,63,143,.441,.461,82,101,.812,25,145,170,41,22,12,48,48,355
Caleb Martin,SF,24,CHO,4,0,28,3,10,.300,0,3,.000,3,7,.429,.300,1,3,.333,1,4,5,3,1,2,3,3,7
Cody Martin,SF,24,CHO,17,0,192,16,43,.372,1,18,.056,15,25,.600,.384,15,22,.682,8,28,36,18,13,1,7,19,48
Kelan Martin,SF,24,MIN,9,0,123,15,44,.341,5,24,.208,10,20,.500,.398,0,0,NA,2,24,26,3,1,1,4,20,35
Frank Mason,PG,25,MIL,2,0,10,1,4,.250,1,2,.500,0,2,.000,.375,1,2,.500,0,0,0,2,0,0,0,1,4
Garrison Mathews,SG,23,WAS,2,0,14,0,2,.000,0,2,.000,0,0,NA,.000,0,0,NA,0,1,1,2,0,0,1,3,0
Wesley Matthews,SG,33,MIL,24,24,578,67,152,.441,40,104,.385,27,48,.563,.572,23,27,.852,4,51,55,36,13,2,19,29,197
Patrick McCaw,SF,24,TOR,2,0,40,3,5,.600,1,3,.333,2,2,1.000,.700,1,2,.500,2,4,6,3,3,0,3,3,8
CJ McCollum,SG,28,POR,25,25,905,217,488,.445,64,171,.374,153,317,.483,.510,43,53,.811,20,91,111,93,19,22,48,71,541
T.J. McConnell,PG,27,IND,22,0,383,65,135,.481,1,4,.250,64,131,.489,.485,10,11,.909,10,49,59,106,11,4,32,27,141
Jalen McDaniels,PF,22,CHO,1,0,3,1,2,.500,0,0,NA,1,2,.500,.500,0,0,NA,1,0,1,0,0,0,0,0,2
Doug McDermott,PF,28,IND,24,0,498,85,183,.464,44,94,.468,41,89,.461,.585,13,15,.867,10,56,66,28,3,3,20,47,227
JaVale McGee,C,32,LAL,24,24,396,78,126,.619,0,0,NA,78,126,.619,.619,17,26,.654,46,101,147,15,14,28,18,54,173
Rodney McGruder,SG,28,LAC,15,2,260,23,60,.383,11,35,.314,12,25,.480,.475,3,8,.375,11,25,36,12,4,3,7,26,60
Alfonzo McKinnie,SF,27,CLE,17,0,175,17,50,.340,8,25,.320,9,25,.360,.420,7,11,.636,10,26,36,3,6,3,8,20,49
Jordan McLaughlin,PG,23,MIN,4,0,57,4,15,.267,1,8,.125,3,7,.429,.300,2,2,1.000,1,6,7,8,1,0,4,4,11
Ben McLemore,SG,26,HOU,23,7,516,76,189,.402,56,161,.348,20,28,.714,.550,25,29,.862,9,47,56,24,15,6,19,47,233
Jordan McRae,SG,28,WAS,13,0,235,43,91,.473,13,33,.394,30,58,.517,.544,17,19,.895,3,28,31,36,8,4,14,26,116
Nicolò Melli,C,29,NOP,22,3,341,41,99,.414,22,67,.328,19,32,.594,.525,19,24,.792,14,45,59,24,14,4,17,42,123
De'Anthony Melton,PG,21,MEM,12,0,171,24,59,.407,5,17,.294,19,42,.452,.449,14,16,.875,8,28,36,34,15,2,17,16,67
Chimezie Metu,PF,22,SAS,6,0,21,7,12,.583,0,0,NA,7,12,.583,.583,2,4,.500,7,4,11,2,0,2,0,0,16
Khris Middleton,SF,28,MIL,17,14,464,110,225,.489,36,90,.400,74,135,.548,.569,42,47,.894,13,85,98,57,14,2,30,42,298
C.J. Miles,SG,32,WAS,10,0,161,19,59,.322,11,35,.314,8,24,.333,.415,15,20,.750,4,8,12,12,10,4,4,14,64
Malcolm Miller,SF,26,TOR,9,1,54,6,12,.500,5,10,.500,1,2,.500,.708,1,6,.167,0,7,7,4,0,2,2,6,18
Patty Mills,PG,31,SAS,23,1,538,90,196,.459,47,113,.416,43,83,.518,.579,29,37,.784,4,28,32,53,21,4,24,35,256
Paul Millsap,PF,34,DEN,22,22,566,97,203,.478,25,54,.463,72,149,.483,.539,65,74,.878,43,86,129,28,20,18,27,59,284
Shake Milton,SG,23,PHI,9,0,82,12,35,.343,4,19,.211,8,16,.500,.400,7,9,.778,1,7,8,7,1,0,12,13,35
Donovan Mitchell,SG,23,UTA,24,24,830,217,496,.438,54,149,.362,163,347,.470,.492,104,124,.839,21,93,114,86,30,6,57,53,592
Naz Mitrou-Long,SG,26,IND,3,0,43,6,16,.375,2,11,.182,4,5,.800,.438,0,0,NA,0,6,6,7,1,1,2,1,14
Malik Monk,SG,21,CHO,26,0,531,91,208,.438,27,99,.273,64,109,.587,.502,30,36,.833,7,61,68,56,10,6,37,42,239
E'Twaun Moore,SG,30,NOP,16,3,326,59,140,.421,21,55,.382,38,85,.447,.496,14,22,.636,13,38,51,23,8,1,11,27,153
Ja Morant,PG,20,MEM,18,18,518,126,272,.463,19,44,.432,107,228,.469,.498,72,93,.774,16,40,56,116,24,5,60,30,343
Juwan Morgan,PF,22,UTA,3,0,9,0,0,NA,0,0,NA,0,0,NA,NA,0,0,NA,0,2,2,0,0,0,1,1,0
Marcus Morris,SF,30,NYK,22,22,712,131,310,.423,61,126,.484,70,184,.380,.521,77,91,.846,24,101,125,27,19,13,40,68,400
Markieff Morris,PF,30,DET,23,12,507,86,186,.462,35,88,.398,51,98,.520,.556,26,34,.765,12,77,89,35,15,4,38,54,233
Monte Morris,PG,24,DEN,22,0,392,62,146,.425,12,30,.400,50,116,.431,.466,22,30,.733,4,34,38,73,11,7,16,20,158
Johnathan Motley,PF,24,LAC,2,0,4,1,3,.333,1,1,1.000,0,2,.000,.500,0,0,NA,1,1,2,2,0,0,2,1,3
Emmanuel Mudiay,PG,23,UTA,21,0,330,59,127,.465,9,31,.290,50,96,.521,.500,22,27,.815,6,46,52,50,6,4,37,35,149
Dejounte Murray,PG,23,SAS,20,13,452,76,168,.452,5,26,.192,71,142,.500,.467,37,47,.787,25,96,121,81,32,5,45,46,194
Jamal Murray,PG,22,DEN,22,22,694,145,333,.435,36,107,.336,109,226,.482,.489,56,62,.903,17,75,92,100,32,8,48,38,382
Džanan Musa,SF,20,BRK,18,0,278,29,90,.322,8,44,.182,21,46,.457,.367,22,29,.759,8,39,47,24,8,1,22,16,88
Mike Muscala,C,28,OKC,15,0,166,18,58,.310,12,44,.273,6,14,.429,.414,7,8,.875,6,29,35,14,4,3,6,20,55
Sviatoslav Mykhailiuk,SF,22,DET,19,1,324,37,86,.430,29,63,.460,8,23,.348,.599,5,6,.833,4,19,23,25,8,1,17,22,108
Abdel Nader,SF,26,OKC,16,3,263,38,79,.481,16,39,.410,22,40,.550,.582,20,24,.833,5,25,30,9,5,6,16,24,112
Larry Nance,C,27,CLE,21,4,545,79,157,.503,25,67,.373,54,90,.600,.583,25,35,.714,41,113,154,31,19,10,22,35,208
Shabazz Napier,PG,28,MIN,11,0,198,27,70,.386,11,44,.250,16,26,.615,.464,21,24,.875,1,22,23,36,12,3,20,11,86
Raul Neto,PG,27,PHI,22,2,268,39,77,.506,14,28,.500,25,49,.510,.597,3,4,.750,3,21,24,36,9,2,20,13,95
Georges Niang,PF,26,UTA,18,0,207,28,61,.459,14,37,.378,14,24,.583,.574,7,10,.700,2,29,31,9,1,2,10,27,77
Nerlens Noel,C,25,OKC,22,3,408,66,102,.647,0,0,NA,66,102,.647,.647,34,43,.791,31,80,111,34,21,35,23,61,166
Zach Norvell,SG,22,LAL,2,0,5,0,1,.000,0,0,NA,0,1,.000,.000,0,0,NA,0,1,1,0,0,0,0,0,0
Jaylen Nowell,SG,20,MIN,2,0,15,1,4,.250,0,3,.000,1,1,1.000,.250,1,1,1.000,0,1,1,3,0,0,1,1,3
Frank Ntilikina,PG,21,NYK,22,18,556,52,138,.377,19,56,.339,33,82,.402,.446,13,17,.765,8,37,45,72,28,10,25,56,136
Kendrick Nunn,SG,24,MIA,24,24,731,154,341,.452,50,145,.345,104,196,.531,.525,31,38,.816,7,57,64,82,25,7,50,61,389
David Nwaba,SF,27,BRK,15,0,184,24,43,.558,7,16,.438,17,27,.630,.640,9,16,.563,7,24,31,5,5,9,6,23,64
Royce O'Neale,PF,26,UTA,24,22,680,49,105,.467,29,65,.446,20,40,.500,.605,12,14,.857,3,108,111,62,19,6,21,72,139
Kyle O'Quinn,C,29,PHI,14,0,147,23,43,.535,5,13,.385,18,30,.600,.593,2,6,.333,16,38,54,20,2,11,15,22,53
Semi Ojeleye,PF,25,BOS,22,1,325,22,52,.423,12,32,.375,10,20,.500,.538,7,10,.700,7,35,42,8,10,1,5,27,63
Jahlil Okafor,C,24,NOP,15,7,274,55,87,.632,1,2,.500,54,85,.635,.638,27,39,.692,25,45,70,21,5,15,25,45,138
Elie Okobo,PG,22,PHO,16,0,152,21,52,.404,10,25,.400,11,27,.407,.500,11,21,.524,2,13,15,38,4,0,4,8,63
Josh Okogie,SG,21,MIN,21,6,523,59,134,.440,16,51,.314,43,83,.518,.500,55,70,.786,31,75,106,34,22,7,31,48,189
KZ Okpala,SF,20,MIA,3,0,3,0,0,NA,0,0,NA,0,0,NA,NA,0,0,NA,0,1,1,0,0,0,1,0,0
Kelly Olynyk,C,28,MIA,24,0,555,70,156,.449,38,92,.413,32,64,.500,.571,31,35,.886,23,94,117,32,22,9,33,65,209
Miye Oni,SG,22,UTA,3,0,8,0,0,NA,0,0,NA,0,0,NA,NA,0,0,NA,0,1,1,0,0,0,1,0,0
Cedi Osman,SF,24,CLE,23,23,672,79,187,.422,36,99,.364,43,88,.489,.519,21,32,.656,9,69,78,47,25,6,29,52,215
Kelly Oubre,SF,24,PHO,23,23,740,141,316,.446,35,107,.327,106,209,.507,.502,86,110,.782,32,105,137,34,31,17,37,76,403
Jabari Parker,PF,24,ATL,24,19,674,159,317,.502,25,91,.275,134,226,.593,.541,45,63,.714,42,111,153,45,35,13,45,74,388
Chandler Parsons,SF,31,ATL,3,0,35,4,12,.333,3,10,.300,1,2,.500,.458,0,0,NA,1,3,4,2,4,0,1,3,11
Eric Paschall,PF,23,GSW,24,18,755,147,296,.497,17,58,.293,130,238,.546,.525,87,107,.813,35,90,125,41,9,9,40,47,398
Patrick Patterson,PF,30,LAC,22,12,307,36,93,.387,30,73,.411,6,20,.300,.548,8,12,.667,14,46,60,17,4,2,7,19,110
Justin Patton,C,22,OKC,2,0,9,1,3,.333,0,1,.000,1,2,.500,.333,0,0,NA,0,2,2,0,0,0,1,4,2
Chris Paul,PG,34,OKC,23,23,712,121,267,.453,35,98,.357,86,169,.509,.519,91,102,.892,6,89,95,135,38,2,39,55,368
Elfrid Payton,PG,25,NYK,7,3,143,17,45,.378,6,12,.500,11,33,.333,.444,7,8,.875,5,14,19,28,14,1,12,12,47
Norvel Pelle,SF,26,PHI,2,0,25,2,3,.667,0,0,NA,2,3,.667,.667,4,6,.667,2,8,10,2,0,4,2,4,8
Theo Pinson,SG,24,BRK,14,0,209,24,89,.270,8,42,.190,16,47,.340,.315,11,12,.917,7,24,31,32,8,0,20,21,67
Mason Plumlee,C,29,DEN,22,0,365,60,103,.583,0,4,.000,60,99,.606,.583,27,51,.529,37,88,125,49,17,17,36,55,147
Vincent Poirier,C,26,BOS,9,0,44,7,14,.500,0,0,NA,7,14,.500,.500,1,2,.500,8,7,15,3,2,2,3,10,15
Jakob Pöltl,C,24,SAS,23,7,435,60,101,.594,0,0,NA,60,101,.594,.594,19,34,.559,53,86,139,35,14,31,21,42,139
Shamorie Ponds,PG,21,TOR,2,0,8,2,4,.500,0,1,.000,2,3,.667,.500,0,0,NA,0,1,1,2,0,1,0,2,4
Jordan Poole,SG,20,GSW,24,9,576,59,229,.258,29,118,.246,30,111,.270,.321,42,49,.857,4,50,54,49,15,6,29,44,189
Kevin Porter,SF,19,CLE,22,1,460,59,143,.413,13,50,.260,46,93,.495,.458,22,30,.733,8,63,71,42,19,5,35,54,153
Michael Porter,PF,21,DEN,13,0,117,23,52,.442,5,15,.333,18,37,.486,.490,7,10,.700,12,23,35,5,0,3,8,16,58
Otto Porter,SF,26,CHI,9,9,226,35,84,.417,16,40,.400,19,44,.432,.512,15,20,.750,8,23,31,14,9,3,7,20,101
Bobby Portis,C,24,NYK,24,2,522,83,207,.401,23,68,.338,60,139,.432,.457,21,29,.724,38,104,142,25,16,9,22,42,210
Kristaps Porziņģis,PF,24,DAL,22,22,665,129,324,.398,44,130,.338,85,194,.438,.466,59,84,.702,37,154,191,30,12,44,35,64,361
Dwight Powell,C,28,DAL,20,17,506,67,98,.684,6,13,.462,61,85,.718,.714,23,41,.561,31,62,93,25,16,8,19,51,163
Norman Powell,SG,26,TOR,23,12,644,110,236,.466,39,109,.358,71,127,.559,.549,47,58,.810,12,77,89,36,24,8,35,41,306
Julius Randle,PF,25,NYK,24,24,763,146,332,.440,20,84,.238,126,248,.508,.470,88,133,.662,57,148,205,82,18,3,76,67,400
Cam Reddish,SF,20,ATL,21,17,519,62,189,.328,21,80,.263,41,109,.376,.384,28,37,.757,15,65,80,33,19,7,37,37,173
J.J. Redick,SG,35,NOP,23,19,653,106,247,.429,75,167,.449,31,80,.388,.581,58,67,.866,4,68,72,47,10,5,30,38,345
Naz Reid,C,20,MIN,2,0,4,1,2,.500,1,2,.500,0,0,NA,.750,0,0,NA,0,1,1,0,0,0,0,1,3
Josh Richardson,SG,26,PHI,17,17,531,94,212,.443,33,86,.384,61,126,.484,.521,40,50,.800,11,45,56,58,19,10,37,48,261
Austin Rivers,SG,27,HOU,22,1,547,67,162,.414,31,95,.326,36,67,.537,.509,20,28,.714,17,43,60,34,11,4,15,44,185
Duncan Robinson,SF,25,MIA,24,19,641,97,201,.483,75,167,.449,22,34,.647,.669,15,16,.938,3,68,71,21,19,9,16,64,284
Glenn Robinson,SF,26,GSW,25,25,802,115,253,.455,30,79,.380,85,174,.489,.514,27,32,.844,36,82,118,43,25,7,22,41,287
Jerome Robinson,SG,22,LAC,20,0,256,29,87,.333,11,40,.275,18,47,.383,.397,5,10,.500,2,32,34,19,7,7,15,28,74
Justin Robinson,PG,22,WAS,5,0,14,2,5,.400,1,1,1.000,1,4,.250,.500,0,0,NA,1,2,3,2,0,0,2,0,5
Mitchell Robinson,C,21,NYK,20,6,430,74,109,.679,0,0,NA,74,109,.679,.679,41,66,.621,59,73,132,12,14,38,17,68,189
Rajon Rondo,PG,33,LAL,13,0,272,42,91,.462,19,36,.528,23,55,.418,.566,8,11,.727,4,42,46,76,14,1,24,13,111
Derrick Rose,PG,31,DET,19,1,451,122,250,.488,14,43,.326,108,207,.522,.516,47,54,.870,9,30,39,110,15,8,47,21,305
Terrence Ross,SG,28,ORL,21,0,513,99,236,.419,43,131,.328,56,105,.533,.511,42,50,.840,6,56,62,21,19,6,25,37,283
Terry Rozier,PG,25,CHO,26,26,855,160,371,.431,70,174,.402,90,197,.457,.526,65,75,.867,21,97,118,112,31,4,72,57,455
Ricky Rubio,PG,29,PHO,18,18,569,81,211,.384,20,64,.313,61,147,.415,.431,46,56,.821,13,73,86,166,24,3,34,48,228
D'Angelo Russell,SG,23,GSW,13,13,402,100,231,.433,37,105,.352,63,126,.500,.513,49,66,.742,4,44,48,81,9,5,43,22,286
Domantas Sabonis,C,23,IND,22,22,758,160,313,.511,5,26,.192,155,287,.540,.519,79,102,.775,79,218,297,82,17,13,61,81,404
JaKarr Sampson,SF,26,IND,9,7,166,23,41,.561,2,10,.200,21,31,.677,.585,2,7,.286,7,17,24,4,5,6,6,23,50
Dario Šarić,PF,25,PHO,23,23,648,93,214,.435,38,110,.345,55,104,.529,.523,35,41,.854,43,124,167,47,20,10,31,61,259
Tomáš Satoranský,PG,28,CHI,25,25,684,85,193,.440,29,75,.387,56,118,.475,.516,37,42,.881,21,62,83,136,37,3,51,51,236
Admiral Schofield,SF,22,WAS,10,0,76,7,12,.583,4,9,.444,3,3,1.000,.750,4,4,1.000,2,9,11,1,0,0,3,7,22
Dennis Schröder,PG,26,OKC,23,0,675,150,327,.459,35,108,.324,115,219,.525,.512,50,62,.806,8,78,86,81,16,7,60,52,385
Mike Scott,PF,31,PHI,25,1,465,57,132,.432,29,84,.345,28,48,.583,.542,12,15,.800,18,64,82,18,8,2,10,38,155
Thabo Sefolosha,PF,35,HOU,19,0,201,16,46,.348,8,28,.286,8,18,.444,.435,0,1,.000,11,34,45,15,9,4,6,19,40
Collin Sexton,SG,21,CLE,23,23,699,153,356,.430,25,80,.313,128,276,.464,.465,67,83,.807,23,49,72,55,20,1,42,45,398
Landry Shamet,SG,22,LAC,10,10,294,30,77,.390,21,58,.362,9,19,.474,.526,10,10,1.000,0,15,15,17,4,1,12,31,91
Iman Shumpert,SG,29,BRK,12,0,226,20,59,.339,7,31,.226,13,28,.464,.398,3,5,.600,9,23,32,12,12,2,10,20,50
Pascal Siakam,PF,25,TOR,23,23,849,211,461,.458,52,143,.364,159,318,.500,.514,90,111,.811,36,158,194,82,21,16,63,62,564
Chris Silva,PF,23,MIA,22,0,214,29,45,.644,0,2,.000,29,43,.674,.644,24,34,.706,41,44,85,13,5,14,25,56,82
Ben Simmons,PG,23,PHI,23,23,790,134,235,.570,2,5,.400,132,230,.574,.574,51,89,.573,36,124,160,193,52,12,88,76,321
Anfernee Simons,SG,20,POR,25,1,543,94,221,.425,38,107,.355,56,114,.491,.511,31,41,.756,7,43,50,39,11,3,24,51,257
Marcus Smart,SG,25,BOS,20,15,635,82,212,.387,42,126,.333,40,86,.465,.486,29,33,.879,19,48,67,91,26,9,25,46,235
Dennis Smith,PG,22,NYK,17,1,293,34,107,.318,10,33,.303,24,74,.324,.364,14,27,.519,12,21,33,46,7,5,26,37,92
Ish Smith,PG,31,WAS,23,9,581,90,200,.450,21,58,.362,69,142,.486,.503,12,19,.632,11,54,65,100,16,8,28,39,213
Tony Snell,SF,28,DET,20,18,508,56,120,.467,38,85,.447,18,35,.514,.625,4,4,1.000,5,31,36,29,8,2,10,37,154
Omari Spellman,PF,22,GSW,24,0,436,67,152,.441,19,50,.380,48,102,.471,.503,36,43,.837,52,79,131,24,16,16,34,27,189
Max Strus,SG,23,CHI,2,0,6,2,3,.667,0,1,.000,2,2,1.000,.667,1,1,1.000,1,0,1,0,0,0,0,1,5
Edmond Sumner,PG,24,IND,4,2,72,9,19,.474,0,3,.000,9,16,.563,.474,3,5,.600,1,2,3,8,5,1,1,9,21
Caleb Swanigan,PF,22,SAC,4,0,11,1,2,.500,0,0,NA,1,2,.500,.500,1,2,.500,1,3,4,0,1,2,3,3,3
Jayson Tatum,PF,21,BOS,22,22,750,168,405,.415,55,149,.369,113,256,.441,.483,73,89,.820,27,131,158,62,32,17,49,49,464
Jeff Teague,PG,31,MIN,19,12,554,79,182,.434,17,49,.347,62,133,.466,.481,74,86,.860,10,41,51,132,18,5,44,41,249
Garrett Temple,SG,33,BRK,23,14,638,83,200,.415,51,141,.362,32,59,.542,.543,19,25,.760,12,62,74,53,22,13,25,46,236
Daniel Theis,C,27,BOS,19,18,409,51,98,.520,5,17,.294,46,81,.568,.546,21,31,.677,29,92,121,26,9,31,17,57,128
Isaiah Thomas,PG,30,WAS,17,14,424,82,184,.446,34,83,.410,48,101,.475,.538,16,20,.800,3,28,31,86,8,4,37,37,214
Khyri Thomas,SG,23,DET,2,0,6,0,0,NA,0,0,NA,0,0,NA,NA,1,2,.500,0,0,0,0,0,0,0,0,1
Matt Thomas,SG,25,TOR,12,0,136,20,37,.541,14,26,.538,6,11,.545,.730,3,5,.600,1,12,13,4,4,0,4,12,57
Tristan Thompson,C,28,CLE,22,22,687,129,248,.520,3,7,.429,126,241,.523,.526,42,74,.568,91,131,222,52,19,25,36,56,303
Matisse Thybulle,SG,22,PHI,24,3,410,41,92,.446,25,54,.463,16,38,.421,.582,15,20,.750,7,22,29,31,35,17,24,56,122
Anthony Tolliver,PF,34,POR,18,7,287,18,61,.295,14,48,.292,4,13,.308,.410,9,11,.818,10,45,55,11,4,6,11,23,59
Karl-Anthony Towns,C,24,MIN,21,21,708,189,366,.516,75,177,.424,114,189,.603,.619,96,120,.800,55,191,246,95,21,29,62,71,549
Gary Trent,SG,21,POR,12,1,103,15,38,.395,11,26,.423,4,12,.333,.539,0,0,NA,3,12,15,5,3,2,3,8,41
Allonzo Trier,PG,24,NYK,12,1,157,28,55,.509,14,32,.438,14,23,.609,.636,26,33,.788,1,16,17,16,2,3,17,22,96
P.J. Tucker,PF,34,HOU,23,23,824,82,161,.509,45,104,.433,37,57,.649,.649,16,20,.800,36,128,164,33,30,12,23,78,225
Evan Turner,PG,31,ATL,14,0,195,23,58,.397,0,4,.000,23,54,.426,.397,12,14,.857,7,22,29,32,8,8,20,16,58
Myles Turner,C,23,IND,16,16,491,63,150,.420,23,64,.359,40,86,.465,.497,25,34,.735,25,65,90,19,11,38,27,40,174
Jonas Valančiūnas,C,27,MEM,21,21,521,125,215,.581,12,32,.375,113,183,.617,.609,37,48,.771,54,152,206,41,8,18,48,61,299
Denzel Valentine,SF,26,CHI,11,0,121,27,58,.466,18,40,.450,9,18,.500,.621,0,0,NA,2,19,21,11,4,2,3,13,72
Jarred Vanderbilt,SF,20,DEN,3,0,9,0,0,NA,0,0,NA,0,0,NA,NA,0,0,NA,0,2,2,1,0,0,1,0,0
Fred VanVleet,PG,25,TOR,22,22,806,126,308,.409,58,147,.395,68,161,.422,.503,85,97,.876,4,79,83,155,44,3,52,51,395
Noah Vonleh,C,24,MIN,16,1,181,20,43,.465,1,10,.100,19,33,.576,.477,16,19,.842,18,36,54,16,4,3,13,20,57
Nikola Vučević,C,29,ORL,14,14,431,95,211,.450,16,50,.320,79,161,.491,.488,33,39,.846,41,121,162,49,9,15,20,27,239
Dean Wade,PF,23,CLE,3,0,18,1,2,.500,1,1,1.000,0,1,.000,.750,0,0,NA,0,2,2,0,1,0,0,3,3
Moritz Wagner,C,22,WAS,21,4,429,93,160,.581,22,56,.393,71,104,.683,.650,36,43,.837,34,93,127,28,15,13,43,81,244
Kemba Walker,PG,29,BOS,21,21,671,150,357,.420,75,186,.403,75,171,.439,.525,83,91,.912,21,72,93,107,20,12,46,36,458
Lonnie Walker,SG,21,SAS,16,0,128,27,62,.435,6,16,.375,21,46,.457,.484,5,13,.385,6,15,21,8,4,2,7,11,65
Tyrone Wallace,SG,25,ATL,14,0,160,14,44,.318,1,15,.067,13,29,.448,.330,11,17,.647,3,19,22,13,7,1,10,19,40
Taurean Waller-Prince,SF,25,BRK,23,23,701,111,272,.408,63,158,.399,48,114,.421,.524,23,31,.742,19,123,142,51,20,9,48,61,308
Derrick Walton,PG,24,LAC,9,0,64,6,12,.500,3,8,.375,3,4,.750,.625,3,3,1.000,2,2,4,5,2,0,1,6,18
Brad Wanamaker,PG,30,BOS,22,0,391,52,111,.468,11,29,.379,41,82,.500,.518,45,51,.882,9,34,43,63,16,5,26,37,160
T.J. Warren,SF,26,IND,24,24,792,177,348,.509,30,76,.395,147,272,.540,.552,58,70,.829,17,67,84,24,26,7,33,68,442
PJ Washington,PF,21,CHO,26,26,748,117,241,.485,37,89,.416,80,152,.526,.562,46,65,.708,23,108,131,47,27,22,35,73,317
Yuta Watanabe,SG,25,MEM,3,0,11,3,5,.600,1,1,1.000,2,4,.500,.700,0,0,NA,0,2,2,0,0,1,0,1,7
Tremont Waters,PG,22,BOS,1,0,20,2,7,.286,1,5,.200,1,2,.500,.357,2,2,1.000,0,2,2,3,1,2,2,2,7
Russell Westbrook,PG,31,HOU,21,21,723,175,416,.421,25,109,.229,150,307,.489,.451,96,129,.744,34,136,170,157,34,8,96,83,471
Coby White,SG,19,CHI,25,0,632,107,299,.358,51,149,.342,56,150,.373,.443,33,42,.786,7,86,93,61,17,0,37,36,298
Derrick White,SG,25,SAS,21,9,501,71,157,.452,20,51,.392,51,106,.481,.516,41,52,.788,11,37,48,61,9,15,26,50,203
Hassan Whiteside,C,30,POR,22,22,618,139,228,.610,0,0,NA,139,228,.610,.610,61,80,.763,81,194,275,30,10,52,43,63,339
Andrew Wiggins,SF,24,MIN,19,19,658,174,384,.453,41,123,.333,133,261,.510,.507,76,105,.724,23,75,98,64,11,24,37,46,465
Grant Williams,PF,21,BOS,21,1,301,15,60,.250,1,26,.038,14,34,.412,.258,14,17,.824,15,30,45,18,8,12,16,39,45
Kenrich Williams,PF,25,NOP,22,12,554,44,107,.411,21,68,.309,23,39,.590,.509,9,22,.409,36,93,129,37,20,16,17,57,118
Lou Williams,SG,33,LAC,25,3,774,163,401,.406,42,122,.344,121,279,.434,.459,132,155,.852,12,66,78,154,13,4,77,39,500
Marvin Williams,PF,33,CHO,24,0,487,63,127,.496,30,75,.400,33,52,.635,.614,27,30,.900,9,57,66,23,16,10,16,40,183
Robert Williams,C,22,BOS,19,1,269,33,49,.673,0,0,NA,33,49,.673,.673,8,14,.571,23,64,87,21,17,21,16,34,74
Nigel Williams-Goss,PG,25,UTA,7,0,22,0,5,.000,0,1,.000,0,4,.000,.000,2,2,1.000,1,1,2,2,0,1,1,1,2
D.J. Wilson,PF,23,MIL,11,0,127,23,46,.500,10,29,.345,13,17,.765,.609,1,1,1.000,4,21,25,9,0,1,6,11,57
Justise Winslow,SF,23,MIA,10,5,337,50,127,.394,6,26,.231,44,101,.436,.417,18,27,.667,16,55,71,43,6,4,23,36,124
Christian Wood,PF,24,DET,22,0,331,73,117,.624,15,31,.484,58,86,.674,.688,36,55,.655,27,72,99,12,7,19,21,21,197
Delon Wright,SG,27,DAL,22,2,466,62,129,.481,13,37,.351,49,92,.533,.531,28,34,.824,17,58,75,74,25,7,15,27,165
Thaddeus Young,PF,31,CHI,24,0,508,83,203,.409,27,79,.342,56,124,.452,.475,17,30,.567,38,62,100,37,22,7,38,40,210
Trae Young,PG,21,ATL,23,23,802,215,469,.458,79,207,.382,136,262,.519,.543,145,169,.858,10,84,94,194,28,1,112,33,654
Cody Zeller,C,27,CHO,23,17,540,106,194,.546,14,40,.350,92,154,.597,.582,36,55,.655,65,113,178,27,13,10,39,57,262
Ante Žižić,C,23,CLE,8,0,85,13,26,.500,0,0,NA,13,26,.500,.500,5,6,.833,7,14,21,0,2,2,1,9,31
Ivica Zubac,C,22,LAC,25,23,419,80,136,.588,0,2,.000,80,134,.597,.588,51,61,.836,60,106,166,23,4,27,22,58,211
