Player,Pos,Age,Tm,G,GS,MP,FG,FGA,FG%,3P,3PA,3P%,2P,2PA,2P%,eFG%,FT,FTA,FT%,ORB,DRB,TRB,AST,STL,BLK,TOV,PF,PTS
Steven Adams,C,26,OKC,21,21,570,97,159,.610,0,1,.000,97,158,.614,.610,34,64,.531,66,131,197,62,10,27,31,39,228
Bam Adebayo,C,22,MIA,24,24,805,137,232,.591,1,8,.125,136,224,.607,.593,91,137,.664,61,192,253,105,34,28,72,64,366
LaMarcus Aldridge,C,34,SAS,21,21,691,161,314,.513,12,33,.364,149,281,.530,.532,62,74,.838,44,103,147,51,13,37,34,46,396
Nickeil Alexander-Walker,SG,21,NOP,21,0,291,48,145,.331,26,77,.338,22,68,.324,.421,11,16,.688,4,42,46,39,7,2,23,26,133
Grayson Allen,SG,24,MEM,13,0,246,38,92,.413,15,43,.349,23,49,.469,.495,15,17,.882,2,36,38,19,5,1,15,21,106
Jarrett Allen,C,21,BRK,24,21,636,119,178,.669,0,1,.000,119,177,.672,.669,67,111,.604,91,162,253,29,18,31,28,60,305
Kadeem Allen,SG,27,NYK,1,0,16,3,6,.500,3,4,.750,0,2,.000,.750,0,0,NA,0,0,0,2,1,0,1,1,9
Al-Farouq Aminu,PF,29,ORL,18,2,380,25,86,.291,9,36,.250,16,50,.320,.343,19,29,.655,24,63,87,21,18,8,17,27,78
Kyle Anderson,PF,26,MEM,18,0,361,48,97,.495,4,16,.250,44,81,.543,.515,17,29,.586,17,63,80,44,13,12,16,31,117
Ryan Anderson,PF,31,HOU,2,0,14,2,7,.286,1,5,.200,1,2,.500,.357,0,0,NA,0,7,7,2,1,0,1,1,5
Giannis Antetokounmpo,PF,25,MIL,24,24,758,275,488,.564,38,119,.319,237,369,.642,.602,153,260,.588,65,252,317,133,31,31,91,77,741
Kostas Antetokounmpo,PF,22,LAL,2,0,3,0,0,NA,0,0,NA,0,0,NA,NA,0,0,NA,0,1,1,0,0,0,0,0,0
Thanasis Antetokounmpo,SF,27,MIL,4,0,25,6,10,.600,0,0,NA,6,10,.600,.600,2,4,.500,3,0,3,4,0,0,2,3,14
Carmelo Anthony,PF,35,POR,11,11,343,65,160,.406,17,43,.395,48,117,.410,.459,28,35,.800,10,52,62,15,13,3,24,35,175
OG Anunoby,SF,22,TOR,23,23,692,102,202,.505,35,88,.398,67,114,.588,.592,20,33,.606,24,106,130,40,31,22,27,54,259
Ryan Arcidiacono,PG,25,CHI,26,0,410,32,89,.360,22,56,.393,10,33,.303,.483,15,20,.750,13,29,42,41,12,2,17,50,101
Trevor Ariza,SF,34,SAC,17,0,384,30,81,.370,21,60,.350,9,21,.429,.500,10,13,.769,8,58,66,20,18,3,13,29,91
D.J. Augustin,PG,32,ORL,24,6,615,75,198,.379,24,81,.296,51,117,.436,.439,52,59,.881,11,47,58,111,18,0,35,28,226
Deandre Ayton,C,21,PHO,1,1,33,9,14,.643,0,0,NA,9,14,.643,.643,0,0,NA,3,8,11,0,1,4,0,2,18
Dwayne Bacon,SG,24,CHO,20,10,382,49,156,.314,10,43,.233,39,113,.345,.346,22,31,.710,9,43,52,25,15,2,19,32,130
Marvin Bagley,PF,20,SAC,2,1,51,11,29,.379,0,1,.000,11,28,.393,.379,3,5,.600,6,10,16,0,1,2,2,3,25
Lonzo Ball,PG,22,NOP,17,12,484,65,174,.374,35,105,.333,30,69,.435,.474,11,17,.647,14,63,77,96,21,6,46,33,176
Mo Bamba,C,21,ORL,22,0,343,50,118,.424,16,45,.356,34,73,.466,.492,7,12,.583,28,84,112,9,6,31,27,46,123
J.J. Barea,PG,35,DAL,6,0,84,20,45,.444,10,17,.588,10,28,.357,.556,2,2,1.000,2,8,10,17,2,1,5,2,52
Harrison Barnes,PF,27,SAC,24,24,850,131,283,.463,31,88,.352,100,195,.513,.518,90,113,.796,27,100,127,56,21,5,39,29,383
RJ Barrett,SG,19,NYK,24,24,772,126,321,.393,25,78,.321,101,243,.416,.431,65,119,.546,26,105,131,75,31,12,57,60,342
Will Barton,SF,29,DEN,20,20,651,111,244,.455,38,94,.404,73,150,.487,.533,35,48,.729,31,100,131,69,21,9,26,42,295
Keita Bates-Diop,SF,24,MIN,12,0,230,35,67,.522,17,35,.486,18,32,.563,.649,6,10,.600,6,28,34,8,4,6,5,13,93
Nicolas Batum,SF,31,CHO,14,0,306,16,46,.348,9,33,.273,7,13,.538,.446,5,5,1.000,16,43,59,43,11,7,19,26,46
Aron Baynes,C,33,PHO,15,12,346,79,146,.541,27,68,.397,52,78,.667,.634,30,41,.732,23,61,84,40,4,10,16,60,215
Kent Bazemore,SF,30,POR,25,4,574,63,185,.341,31,90,.344,32,95,.337,.424,36,45,.800,10,96,106,40,22,18,35,74,193
Darius Bazley,PF,19,OKC,24,1,405,33,89,.371,15,44,.341,18,45,.400,.455,11,18,.611,8,83,91,12,8,10,20,22,92
Bradley Beal,SG,26,WAS,23,23,850,218,487,.448,58,176,.330,160,311,.514,.507,137,164,.835,24,80,104,162,21,6,81,62,631
Malik Beasley,SG,23,DEN,18,0,283,43,113,.381,22,54,.407,21,59,.356,.478,6,7,.857,5,21,26,18,8,2,17,19,114
Marco Belinelli,SG,33,SAS,21,0,340,39,124,.315,21,63,.333,18,61,.295,.399,15,21,.714,1,34,35,32,5,0,9,17,114
Jordan Bell,C,25,MIN,14,0,139,20,35,.571,0,5,.000,20,30,.667,.571,13,21,.619,16,32,48,8,0,7,14,10,53
DeAndre' Bembry,SG,25,ATL,25,4,609,73,150,.487,9,38,.237,64,112,.571,.517,18,37,.486,25,82,107,63,34,12,39,52,173
Dragan Bender,SF,22,MIL,3,0,29,6,8,.750,2,4,.500,4,4,1.000,.875,1,1,1.000,0,2,2,3,0,2,1,6,15
Dāvis Bertāns,PF,27,WAS,23,1,665,120,253,.474,92,198,.465,28,55,.509,.656,28,32,.875,22,86,108,36,14,14,14,58,360
Patrick Beverley,PG,31,LAC,24,24,707,69,172,.401,34,103,.330,35,69,.507,.500,14,23,.609,33,118,151,77,35,13,35,87,186
Khem Birch,C,27,ORL,15,10,343,26,51,.510,0,1,.000,26,50,.520,.510,13,26,.500,31,54,85,17,10,11,11,40,65
Goga Bitadze,C,20,IND,19,2,220,26,57,.456,4,14,.286,22,43,.512,.491,14,19,.737,16,36,52,14,1,19,10,33,70
Bismack Biyombo,C,27,CHO,25,10,429,73,128,.570,0,0,NA,73,128,.570,.570,44,75,.587,46,74,120,20,6,18,15,51,190
Nemanja Bjelica,PF,31,SAC,24,23,631,109,227,.480,45,104,.433,64,123,.520,.579,16,17,.941,45,116,161,62,24,13,41,73,279
Eric Bledsoe,PG,30,MIL,25,25,676,144,302,.477,32,92,.348,112,210,.533,.530,59,74,.797,21,103,124,143,21,12,58,59,379
Bogdan Bogdanović,SG,27,SAC,22,0,606,112,273,.410,57,153,.373,55,120,.458,.515,34,50,.680,6,56,62,89,27,2,40,43,315
Bojan Bogdanović,SF,30,UTA,24,24,795,164,365,.449,74,167,.443,90,198,.455,.551,85,96,.885,16,89,105,49,17,4,68,47,487
Jonah Bolden,PF,24,PHI,2,0,5,1,1,1.000,0,0,NA,1,1,1.000,1.000,0,2,.000,0,0,0,0,1,0,1,0,2
Jordan Bone,PG,22,DET,3,0,6,2,5,.400,0,1,.000,2,4,.500,.400,0,0,NA,0,0,0,0,0,0,2,2,4
Isaac Bonga,SF,20,WAS,18,12,279,25,52,.481,4,15,.267,21,37,.568,.519,10,13,.769,12,32,44,24,12,4,10,38,64
Devin Booker,SG,23,PHO,24,24,861,213,420,.507,54,133,.406,159,287,.554,.571,121,134,.903,15,78,93,154,15,8,91,72,601
Chris Boucher,PF,27,TOR,21,0,249,41,91,.451,11,34,.324,30,57,.526,.511,20,29,.690,41,47,88,10,7,15,8,28,113
Brian Bowen,SG,21,IND,3,0,10,1,4,.250,0,1,.000,1,3,.333,.250,0,0,NA,0,1,1,0,0,1,0,0,2
Ky Bowman,PG,22,GSW,26,6,596,88,194,.454,27,65,.415,61,129,.473,.523,20,22,.909,13,56,69,70,23,3,31,55,223
Avery Bradley,SG,29,LAL,11,10,291,42,88,.477,8,29,.276,34,59,.576,.523,6,8,.750,7,27,34,18,10,1,11,28,98
Tony Bradley,C,22,UTA,18,2,164,33,54,.611,0,0,NA,33,54,.611,.611,11,16,.688,25,38,63,5,2,8,8,28,77
Jarrell Brantley,PF,23,UTA,2,0,9,0,0,NA,0,0,NA,0,0,NA,NA,0,0,NA,0,4,4,1,0,2,1,1,0
Ignas Brazdeikis,SF,21,NYK,7,0,47,5,20,.250,1,8,.125,4,12,.333,.275,3,4,.750,2,3,5,2,0,1,2,3,14
Mikal Bridges,SF,23,PHO,24,0,506,62,124,.500,12,40,.300,50,84,.595,.548,34,44,.773,21,67,88,26,32,8,20,44,170
Miles Bridges,SF,21,CHO,27,27,838,134,305,.439,47,120,.392,87,185,.470,.516,34,46,.739,35,105,140,49,13,21,44,56,349
Oshae Brissett,SF,21,TOR,4,0,17,1,3,.333,1,1,1.000,0,2,.000,.500,0,0,NA,0,1,1,1,1,0,1,0,3
Ryan Broekhoff,SG,29,DAL,4,0,25,4,8,.500,4,5,.800,0,3,.000,.750,0,0,NA,0,5,5,3,1,0,1,1,12
Malcolm Brogdon,PG,27,IND,21,21,664,145,304,.477,32,90,.356,113,214,.528,.530,88,93,.946,12,83,95,157,21,4,59,43,410
Dillon Brooks,SG,24,MEM,24,24,659,121,298,.406,40,112,.357,81,186,.435,.473,50,61,.820,25,58,83,46,27,8,31,89,332
Bruce Brown,SG,23,DET,24,20,632,71,167,.425,13,39,.333,58,128,.453,.464,22,39,.564,21,82,103,86,22,12,43,64,177
Charlie Brown,SG,22,ATL,4,0,16,1,3,.333,1,1,1.000,0,2,.000,.500,4,4,1.000,2,1,3,0,0,1,0,0,7
Jaylen Brown,SF,23,BOS,20,20,668,151,299,.505,40,106,.377,111,193,.575,.572,56,77,.727,20,120,140,45,22,7,35,67,398
Moses Brown,C,20,POR,4,0,15,3,7,.429,0,0,NA,3,7,.429,.429,2,4,.500,2,7,9,0,1,0,1,4,8
Sterling Brown,SF,24,MIL,17,0,283,34,82,.415,17,43,.395,17,39,.436,.518,12,17,.706,11,70,81,25,12,2,16,23,97
Troy Brown,SG,20,WAS,20,11,442,60,133,.451,9,36,.250,51,97,.526,.485,19,25,.760,27,77,104,44,28,3,20,30,148
Jalen Brunson,PG,23,DAL,23,3,360,68,137,.496,14,43,.326,54,94,.574,.547,22,31,.710,13,41,54,59,11,0,20,26,172
Thomas Bryant,C,22,WAS,18,18,511,101,184,.549,10,35,.286,91,149,.611,.576,39,53,.736,42,111,153,48,8,18,24,44,251
Trey Burke,PG,27,PHI,9,0,152,25,58,.431,6,16,.375,19,42,.452,.483,8,11,.727,6,7,13,31,7,1,4,7,64
Alec Burks,SG,28,GSW,23,10,676,116,276,.420,33,94,.351,83,182,.456,.480,85,95,.895,16,88,104,67,26,6,34,50,350
Deonte Burton,SG,26,OKC,12,0,101,13,33,.394,5,17,.294,8,16,.500,.470,3,4,.750,3,18,21,4,1,1,4,11,34
Jimmy Butler,SF,30,MIA,20,20,702,119,275,.433,21,69,.304,98,206,.476,.471,153,185,.827,41,96,137,139,42,15,52,27,412
Bruno Caboclo,SF,24,MEM,15,0,160,26,59,.441,4,20,.200,22,39,.564,.475,2,3,.667,14,21,35,8,7,11,7,17,58
Kentavious Caldwell-Pope,SG,26,LAL,25,15,607,77,170,.453,31,78,.397,46,92,.500,.544,21,25,.840,11,40,51,42,21,4,22,42,206
Vlatko Čančar,SF,22,DEN,1,0,2,0,0,NA,0,0,NA,0,0,NA,NA,0,0,NA,0,0,0,0,0,0,0,0,0
Clint Capela,C,25,HOU,20,20,658,127,195,.651,0,0,NA,127,195,.651,.651,28,60,.467,87,207,294,20,17,38,34,56,282
DeMarre Carroll,SF,33,SAS,11,0,120,7,25,.280,3,12,.250,4,13,.308,.340,10,14,.714,7,22,29,10,2,2,9,17,27
Jevon Carter,PG,24,PHO,16,2,225,22,55,.400,14,34,.412,8,21,.381,.527,4,4,1.000,3,24,27,28,13,5,15,24,62
Vince Carter,SF,43,ATL,20,0,314,43,117,.368,23,79,.291,20,38,.526,.466,7,10,.700,4,36,40,18,7,6,14,33,116
Wendell Carter,C,20,CHI,26,26,771,122,214,.570,2,15,.133,120,199,.603,.575,70,99,.707,91,165,256,25,18,20,38,106,316
Michael Carter-Williams,SG,28,ORL,14,0,218,20,63,.317,4,21,.190,16,42,.381,.349,19,27,.704,14,30,44,28,13,7,14,21,63
Alex Caruso,PG,25,LAL,23,0,482,50,111,.450,18,48,.375,32,63,.508,.532,14,22,.636,4,47,51,43,25,7,25,36,132
Willie Cauley-Stein,C,26,GSW,23,22,515,81,147,.551,0,0,NA,81,147,.551,.551,22,33,.667,35,114,149,35,23,30,21,65,184
Tyson Chandler,C,37,HOU,18,4,163,13,17,.765,0,0,NA,13,17,.765,.765,5,9,.556,19,30,49,6,5,7,6,24,31
Zylan Cheatham,SF,24,NOP,2,0,20,1,4,.250,0,1,.000,1,3,.333,.250,0,0,NA,0,3,3,1,0,0,1,3,2
Chris Chiozza,PG,24,WAS,9,0,104,7,28,.250,5,11,.455,2,17,.118,.339,0,0,NA,0,11,11,26,8,2,7,10,19
Marquese Chriss,PF,22,GSW,25,1,449,65,137,.474,4,20,.200,61,117,.521,.489,47,56,.839,39,83,122,48,18,25,36,50,181
Gary Clark,PF,25,HOU,9,0,104,12,30,.400,9,25,.360,3,5,.600,.550,2,2,1.000,6,15,21,5,1,3,1,9,35
Brandon Clarke,PF,23,MEM,19,2,403,97,152,.638,12,24,.500,85,128,.664,.678,22,28,.786,24,89,113,23,9,19,20,33,228
Jordan Clarkson,SG,27,CLE,24,0,539,111,266,.417,44,127,.346,67,139,.482,.500,67,75,.893,16,39,55,60,13,7,33,29,333
Nicolas Claxton,PF,20,BRK,9,0,119,11,21,.524,0,5,.000,11,16,.688,.524,5,12,.417,8,14,22,11,1,5,6,10,27
Chris Clemons,SG,22,HOU,17,0,143,26,62,.419,19,49,.388,7,13,.538,.573,3,4,.750,2,8,10,6,3,2,6,14,74
John Collins,PF,22,ATL,5,5,161,32,61,.525,9,19,.474,23,42,.548,.598,12,17,.706,10,34,44,8,5,10,7,17,85
Zach Collins,PF,22,POR,3,3,86,9,19,.474,3,7,.429,6,12,.500,.553,6,6,1.000,4,8,12,6,0,2,6,11,27
Mike Conley,PG,32,UTA,21,21,628,97,263,.369,40,107,.374,57,156,.365,.445,58,73,.795,16,57,73,96,15,4,44,45,292
Pat Connaughton,SG,27,MIL,23,0,399,47,96,.490,18,54,.333,29,42,.690,.583,13,17,.765,11,78,89,42,8,11,13,23,125
Quinn Cook,PG,26,LAL,20,0,267,42,98,.429,12,35,.343,30,63,.476,.490,4,5,.800,4,19,23,30,6,1,16,12,100
Tyler Cook,PF,22,CLE,6,0,17,5,6,.833,0,0,NA,5,6,.833,.833,2,2,1.000,3,2,5,0,1,0,1,1,12
Robert Covington,PF,29,MIN,23,23,642,97,215,.451,48,132,.364,49,83,.590,.563,47,53,.887,17,105,122,26,31,19,36,71,289
Allen Crabbe,SG,27,ATL,13,1,255,28,69,.406,14,44,.318,14,25,.560,.507,7,9,.778,5,26,31,13,8,3,5,11,77
Torrey Craig,SF,29,DEN,15,2,200,16,43,.372,4,20,.200,12,23,.522,.419,4,9,.444,9,26,35,15,5,12,6,28,40
Jae Crowder,SF,29,MEM,24,24,745,84,218,.385,50,154,.325,34,64,.531,.500,37,51,.725,17,127,144,67,24,8,35,51,255
Jarrett Culver,SG,20,MIN,24,14,564,85,224,.379,23,89,.258,62,135,.459,.431,23,53,.434,26,55,81,55,21,12,31,49,216
Seth Curry,SG,29,DAL,21,9,445,56,130,.431,31,81,.383,25,49,.510,.550,29,31,.935,8,32,40,34,12,4,16,38,172
Stephen Curry,PG,31,GSW,4,4,112,27,66,.409,9,37,.243,18,29,.621,.477,18,18,1.000,4,16,20,26,5,2,15,10,81
Troy Daniels,SG,28,LAL,20,0,278,34,92,.370,24,69,.348,10,23,.435,.500,4,7,.571,4,24,28,7,7,1,6,14,96
Anthony Davis,PF,26,LAL,24,24,827,228,458,.498,26,79,.329,202,379,.533,.526,170,196,.867,60,160,220,81,37,63,54,55,652
Ed Davis,C,30,UTA,13,0,159,10,21,.476,0,0,NA,10,21,.476,.476,3,7,.429,15,42,57,6,5,7,9,31,23
Terence Davis,SG,22,TOR,24,0,375,58,121,.479,27,65,.415,31,56,.554,.591,16,17,.941,14,56,70,44,11,6,20,43,159
Dewayne Dedmon,C,30,SAC,21,4,305,42,103,.408,11,48,.229,31,55,.564,.461,11,13,.846,26,59,85,8,9,11,31,55,106
Matthew Dellavedova,PG,29,CLE,22,0,291,19,67,.284,4,38,.105,15,29,.517,.313,13,14,.929,7,23,30,49,8,1,15,33,55
DeMar DeRozan,SF,30,SAS,23,23,787,189,372,.508,5,14,.357,184,358,.514,.515,109,134,.813,12,118,130,111,22,11,59,66,492
Cheick Diallo,C,23,PHO,17,0,174,41,59,.695,1,1,1.000,40,58,.690,.703,15,17,.882,14,38,52,9,2,4,8,20,98
Hamidou Diallo,SF,21,OKC,12,1,256,46,92,.500,2,13,.154,44,79,.557,.511,11,18,.611,14,32,46,10,18,4,14,29,105
Gorgui Dieng,C,30,MIN,20,2,249,34,81,.420,8,28,.286,26,53,.491,.469,12,16,.750,17,61,78,21,13,20,14,29,88
Spencer Dinwiddie,SG,26,BRK,24,13,716,164,382,.429,45,147,.306,119,235,.506,.488,125,149,.839,5,67,72,148,21,11,64,83,498
Donte DiVincenzo,SG,23,MIL,22,10,465,70,164,.427,29,82,.354,41,82,.500,.515,20,26,.769,18,73,91,35,32,3,26,36,189
Luka Dončić,PG,20,DAL,23,23,769,222,466,.476,70,219,.320,152,247,.615,.552,175,215,.814,31,195,226,211,30,3,105,55,689
Luguentz Dort,SG,20,OKC,4,0,69,5,15,.333,0,8,.000,5,7,.714,.333,3,5,.600,0,6,6,1,2,0,2,12,13
Damyean Dotson,SG,25,NYK,21,0,336,47,118,.398,21,70,.300,26,48,.542,.487,10,14,.714,4,32,36,22,9,4,11,20,125
Sekou Doumbouya,SF,19,DET,4,0,11,3,6,.500,0,1,.000,3,5,.600,.500,0,1,.000,0,2,2,0,0,0,0,3,6
Goran Dragić,PG,33,MIA,18,1,517,97,208,.466,39,96,.406,58,112,.518,.560,54,76,.711,6,52,58,90,12,4,47,32,287
Andre Drummond,C,26,DET,24,24,811,175,325,.538,0,12,.000,175,313,.559,.538,69,108,.639,113,288,401,72,40,45,87,92,419
Jared Dudley,SF,34,LAL,16,0,122,8,16,.500,8,12,.667,0,4,.000,.750,2,2,1.000,2,12,14,9,5,1,2,11,26
Kris Dunn,PG,25,CHI,26,7,565,76,180,.422,11,60,.183,65,120,.542,.453,14,19,.737,14,69,83,75,51,8,27,91,177
Carsen Edwards,SG,21,BOS,21,0,236,27,84,.321,17,51,.333,10,33,.303,.423,11,13,.846,5,31,36,17,7,2,12,22,82
Henry Ellenson,PF,23,BRK,1,0,3,0,0,NA,0,0,NA,0,0,NA,NA,0,0,NA,0,0,0,0,0,0,0,0,0
Wayne Ellington,SG,32,NYK,18,1,257,26,81,.321,21,69,.304,5,12,.417,.451,4,6,.667,1,28,29,16,5,2,12,20,77
Joel Embiid,C,25,PHI,20,20,608,141,308,.458,21,70,.300,120,238,.504,.492,136,168,.810,50,197,247,62,19,27,68,69,439
James Ennis,SF,29,PHI,25,0,438,63,126,.500,23,55,.418,40,71,.563,.591,36,46,.783,28,58,86,22,14,7,16,48,185
Drew Eubanks,PF,22,SAS,4,0,31,5,10,.500,0,0,NA,5,10,.500,.500,1,1,1.000,5,8,13,2,0,1,4,4,11
Jacob Evans,SG,22,GSW,5,0,60,6,18,.333,4,8,.500,2,10,.200,.444,4,4,1.000,1,5,6,3,0,0,2,7,20
Dante Exum,SG,24,UTA,11,0,83,10,23,.435,2,6,.333,8,17,.471,.478,2,2,1.000,3,9,12,7,1,2,10,8,24
Tacko Fall,C,24,BOS,1,0,4,2,4,.500,0,0,NA,2,4,.500,.500,0,0,NA,0,3,3,0,0,0,1,2,4
Derrick Favors,C,28,NOP,9,7,189,36,58,.621,1,2,.500,35,56,.625,.629,2,6,.333,31,49,80,19,5,4,14,21,75
Terrance Ferguson,SF,21,OKC,19,19,497,39,92,.424,23,65,.354,16,27,.593,.549,7,9,.778,11,25,36,19,10,6,14,57,108
Bruno Fernando,C,21,ATL,25,0,296,41,77,.532,4,16,.250,37,61,.607,.558,16,25,.640,28,45,73,27,6,9,23,39,102
Yogi Ferrell,PG,26,SAC,20,0,280,42,93,.452,9,31,.290,33,62,.532,.500,27,31,.871,4,22,26,35,10,1,14,17,120
Dorian Finney-Smith,PF,26,DAL,23,20,618,73,155,.471,28,85,.329,45,70,.643,.561,24,34,.706,43,73,116,25,14,10,24,43,198
Bryn Forbes,SG,26,SAS,23,23,619,105,251,.418,55,152,.362,50,99,.505,.528,31,37,.838,7,50,57,46,12,0,16,44,296
Evan Fournier,SG,27,ORL,24,24,741,166,346,.480,67,152,.441,99,194,.510,.577,79,94,.840,4,66,70,78,22,4,50,54,478
De'Aaron Fox,PG,22,SAC,9,9,288,55,128,.430,10,30,.333,45,98,.459,.469,44,62,.710,5,31,36,63,7,5,37,27,164
Melvin Frazier,SG,23,ORL,4,0,11,1,6,.167,0,1,.000,1,5,.200,.167,0,0,NA,1,0,1,1,0,0,0,1,2
Tim Frazier,PG,29,DET,13,4,138,9,42,.214,3,14,.214,6,28,.214,.250,11,14,.786,4,9,13,38,8,2,12,18,32
Markelle Fultz,PG,21,ORL,23,18,593,113,236,.479,8,38,.211,105,198,.530,.496,42,53,.792,10,53,63,94,29,4,42,49,276
Wenyen Gabriel,PF,22,SAC,7,0,47,5,16,.313,1,8,.125,4,8,.500,.344,5,9,.556,4,4,8,3,2,2,3,6,16
Daniel Gafford,C,21,CHI,17,0,179,34,46,.739,0,0,NA,34,46,.739,.739,10,21,.476,14,15,29,4,1,15,3,29,78
Danilo Gallinari,PF,31,OKC,23,23,702,128,289,.443,63,158,.399,65,131,.496,.552,97,107,.907,12,122,134,49,16,3,34,36,416
Langston Galloway,SG,28,DET,24,6,662,96,213,.451,61,142,.430,35,71,.493,.594,45,50,.900,9,43,52,37,14,8,19,30,298
Darius Garland,PG,20,CLE,24,24,670,99,261,.379,40,109,.367,59,152,.388,.456,23,27,.852,8,35,43,66,16,0,59,34,261
Marc Gasol,C,35,TOR,24,24,693,53,152,.349,28,79,.354,25,73,.342,.441,19,26,.731,21,137,158,87,18,28,33,81,153
Rudy Gay,PF,33,SAS,23,4,532,96,209,.459,20,73,.274,76,136,.559,.507,48,54,.889,31,105,136,44,10,13,38,34,260
Paul George,SF,29,LAC,15,15,450,111,256,.434,59,148,.399,52,108,.481,.549,67,73,.918,8,86,94,53,21,7,50,38,348
Taj Gibson,C,34,NYK,23,17,374,50,99,.505,2,10,.200,48,89,.539,.515,9,15,.600,42,59,101,28,15,6,16,49,111
Harry Giles,PF,21,SAC,7,0,52,11,25,.440,0,0,NA,11,25,.440,.440,2,2,1.000,3,4,7,5,2,3,5,13,24
Shai Gilgeous-Alexander,SG,21,OKC,24,24,837,160,372,.430,34,96,.354,126,276,.457,.476,92,116,.793,16,107,123,73,24,11,52,45,446
Rudy Gobert,C,27,UTA,23,23,781,129,189,.683,0,0,NA,129,189,.683,.683,79,129,.612,81,233,314,33,19,41,52,72,337
Brandon Goodwin,PG,24,ATL,2,0,5,0,1,.000,0,1,.000,0,0,NA,.000,0,0,NA,0,0,0,0,0,0,2,1,0
Aaron Gordon,PF,24,ORL,21,21,657,105,247,.425,26,83,.313,79,164,.482,.478,51,71,.718,36,114,150,61,15,11,31,46,287
Eric Gordon,SG,31,HOU,9,2,265,34,110,.309,21,74,.284,13,36,.361,.405,9,14,.643,3,14,17,7,5,2,12,21,98
Devonte' Graham,PG,24,CHO,27,17,913,174,419,.415,103,240,.429,71,179,.397,.538,89,110,.809,29,71,100,205,19,6,80,48,540
Treveon Graham,SG,26,MIN,23,17,494,47,138,.341,13,63,.206,34,75,.453,.388,19,24,.792,23,54,77,24,14,2,13,50,126
Jerami Grant,PF,25,DEN,22,0,483,75,169,.444,27,75,.360,48,94,.511,.524,25,42,.595,11,63,74,24,9,14,18,41,202
Josh Gray,PG,26,NOP,2,0,23,1,2,.500,0,0,NA,1,2,.500,.500,0,0,NA,1,1,2,2,0,0,5,1,2
Danny Green,SG,32,LAL,25,25,637,75,175,.429,47,124,.379,28,51,.549,.563,8,11,.727,17,79,96,32,32,13,23,59,205
Draymond Green,PF,29,GSW,17,17,490,56,137,.409,12,45,.267,44,92,.478,.453,31,43,.721,7,98,105,101,29,11,39,44,155
JaMychal Green,PF,29,LAC,22,0,469,55,133,.414,34,90,.378,21,43,.488,.541,18,21,.857,29,116,145,10,13,7,20,54,162
Javonte Green,SF,26,BOS,17,0,115,21,35,.600,3,10,.300,18,25,.720,.643,2,5,.400,3,14,17,4,4,3,3,12,47
Jeff Green,PF,33,UTA,25,2,473,66,164,.402,32,91,.352,34,73,.466,.500,45,56,.804,10,57,67,16,10,10,26,43,209
Blake Griffin,PF,30,DET,12,12,352,69,173,.399,22,71,.310,47,102,.461,.462,58,75,.773,12,47,59,39,5,4,33,17,218
Marko Guduric,SG,24,MEM,24,0,352,46,117,.393,18,58,.310,28,59,.475,.470,13,15,.867,12,36,48,34,8,5,27,24,123
Rui Hachimura,PF,21,WAS,23,23,684,139,289,.481,9,45,.200,130,244,.533,.497,44,51,.863,38,101,139,40,18,3,19,54,331
Devon Hall,SG,24,OKC,5,0,20,1,5,.200,0,2,.000,1,3,.333,.200,3,4,.750,0,1,1,3,0,0,1,1,5
Tim Hardaway,SG,27,DAL,23,10,570,103,238,.433,56,147,.381,47,91,.516,.550,41,50,.820,7,42,49,41,14,3,12,44,303
James Harden,SG,30,HOU,24,24,909,258,586,.440,117,335,.349,141,251,.562,.540,295,335,.881,22,120,142,180,48,15,123,78,928
Maurice Harkless,SF,26,LAC,26,16,610,62,128,.484,15,44,.341,47,84,.560,.543,17,30,.567,25,69,94,29,27,19,25,75,156
Jared Harper,PG,22,PHO,1,0,2,0,1,.000,0,1,.000,0,0,NA,.000,0,0,NA,0,0,0,0,0,0,0,0,0
Montrezl Harrell,C,26,LAC,26,2,762,201,340,.591,0,10,.000,201,330,.609,.591,85,136,.625,74,128,202,55,19,32,44,61,487
Gary Harris,SG,25,DEN,22,22,702,89,215,.414,33,92,.359,56,123,.455,.491,25,32,.781,11,56,67,44,26,7,21,47,236
Joe Harris,SF,28,BRK,24,24,757,130,272,.478,67,153,.438,63,119,.529,.601,22,27,.815,22,71,93,50,17,8,34,61,349
Tobias Harris,PF,27,PHI,25,25,856,189,390,.485,36,111,.324,153,279,.548,.531,67,84,.798,18,157,175,79,23,20,51,67,481
Shaquille Harrison,SF,26,CHI,16,4,141,20,49,.408,3,10,.300,17,39,.436,.439,11,18,.611,6,24,30,22,8,4,6,16,54
Josh Hart,SF,24,NOP,18,4,490,67,163,.411,40,113,.354,27,50,.540,.534,26,34,.765,18,90,108,26,19,6,22,50,200
Isaiah Hartenstein,C,21,HOU,8,0,96,11,15,.733,0,1,.000,11,14,.786,.733,9,11,.818,8,18,26,4,2,4,6,16,31
Udonis Haslem,PF,39,MIA,2,0,11,1,1,1.000,0,0,NA,1,1,1.000,1.000,3,4,.750,0,3,3,0,0,0,0,3,5
Jaxson Hayes,C,19,NOP,22,10,466,76,123,.618,0,3,.000,76,120,.633,.618,50,75,.667,42,59,101,15,19,24,19,68,202
Gordon Hayward,SF,29,BOS,10,10,300,72,128,.563,13,34,.382,59,94,.628,.613,17,21,.810,7,56,63,40,7,2,19,17,174
John Henson,PF,29,CLE,6,0,72,14,25,.560,0,5,.000,14,20,.700,.560,3,9,.333,6,9,15,8,4,6,5,6,31
Dewan Hernandez,C,23,TOR,3,0,9,1,5,.200,0,1,.000,1,4,.250,.200,2,2,1.000,2,5,7,0,1,0,1,5,4
Juan Hernangómez,PF,24,DEN,15,0,210,21,57,.368,12,37,.324,9,20,.450,.474,5,9,.556,8,28,36,11,1,3,9,14,59
Willy Hernangómez,C,25,CHO,8,0,60,9,22,.409,2,6,.333,7,16,.438,.455,4,8,.500,9,12,21,2,1,3,5,4,24
Tyler Herro,SG,20,MIA,23,3,660,117,267,.438,47,124,.379,70,143,.490,.526,39,47,.830,6,83,89,45,18,3,46,32,320
Mario Hezonja,PF,24,POR,22,4,384,35,97,.361,10,31,.323,25,66,.379,.412,22,27,.815,16,86,102,22,13,2,20,50,102
Buddy Hield,SG,27,SAC,24,24,825,188,447,.421,94,253,.372,94,194,.485,.526,46,54,.852,22,94,116,68,21,9,61,63,516
George Hill,PG,33,MIL,23,0,484,77,140,.550,36,67,.537,41,73,.562,.679,31,37,.838,23,44,67,72,20,2,19,38,221
Solomon Hill,SF,28,MEM,22,1,443,48,118,.407,24,65,.369,24,53,.453,.508,11,18,.611,12,61,73,40,24,2,20,36,131
Jaylen Hoard,SF,20,POR,5,0,18,3,6,.500,0,0,NA,3,6,.500,.500,1,2,.500,3,4,7,2,1,0,0,1,7
Aaron Holiday,PG,23,IND,23,9,489,81,196,.413,34,87,.391,47,109,.431,.500,13,15,.867,9,49,58,62,20,2,30,34,209
Jrue Holiday,SG,29,NOP,23,23,826,181,396,.457,41,120,.342,140,276,.507,.509,42,63,.667,28,88,116,152,43,17,79,58,445
Justin Holiday,SG,30,IND,25,2,634,70,168,.417,41,102,.402,29,66,.439,.539,19,23,.826,12,85,97,38,27,16,16,44,200
Rondae Hollis-Jefferson,SF,25,TOR,17,0,344,58,108,.537,1,5,.200,57,103,.553,.542,28,39,.718,43,50,93,24,13,6,22,32,145
Richaun Holmes,C,26,SAC,24,20,698,126,188,.670,0,0,NA,126,188,.670,.670,46,58,.793,68,137,205,24,26,33,24,97,298
Rodney Hood,SF,27,POR,21,21,619,87,172,.506,35,71,.493,52,101,.515,.608,21,27,.778,10,62,72,32,17,4,19,46,230
Al Horford,C,33,PHI,23,23,708,129,269,.480,34,93,.366,95,176,.540,.543,25,37,.676,40,117,157,89,26,23,28,54,317
Talen Horton-Tucker,SG,19,LAL,1,0,2,0,1,.000,0,1,.000,0,0,NA,.000,0,0,NA,0,0,0,1,0,0,0,0,0
Danuel House,SF,26,HOU,18,16,533,68,152,.447,43,105,.410,25,47,.532,.589,32,39,.821,20,54,74,25,20,11,18,40,211
Dwight Howard,C,34,LAL,25,0,498,67,93,.720,1,3,.333,66,90,.733,.726,35,69,.507,52,123,175,19,10,34,27,90,170
Kevin Huerter,SG,21,ATL,14,6,315,41,100,.410,24,65,.369,17,35,.486,.530,14,17,.824,7,34,41,47,10,6,19,26,120
De'Andre Hunter,SF,22,ATL,24,23,757,107,265,.404,44,120,.367,63,145,.434,.487,42,55,.764,12,83,95,45,14,7,39,61,300
Chandler Hutchison,SF,23,CHI,9,6,154,20,44,.455,5,12,.417,15,32,.469,.511,19,29,.655,1,32,33,8,5,2,12,12,64
Serge Ibaka,C,30,TOR,14,0,309,65,150,.433,12,35,.343,53,115,.461,.473,29,35,.829,24,72,96,18,6,13,29,35,171
Ersan İlyasova,PF,32,MIL,23,1,374,66,129,.512,19,57,.333,47,72,.653,.585,27,33,.818,30,83,113,16,11,7,6,39,178
Joe Ingles,SF,32,UTA,25,5,704,69,178,.388,38,114,.333,31,64,.484,.494,26,34,.765,6,96,102,102,25,2,43,58,202
Brandon Ingram,PF,22,NOP,21,21,707,188,384,.490,49,120,.408,139,264,.527,.553,98,116,.845,17,132,149,80,16,18,62,64,523
Kyrie Irving,PG,27,BRK,11,11,372,112,252,.444,31,91,.341,81,161,.503,.506,59,63,.937,10,49,59,79,12,6,26,32,314
Jonathan Isaac,SF,22,ORL,22,22,683,107,239,.448,26,77,.338,81,162,.500,.502,38,47,.809,39,122,161,30,28,62,35,52,278
Wesley Iwundu,SF,25,ORL,12,3,178,13,41,.317,1,11,.091,12,30,.400,.329,15,18,.833,5,21,26,10,7,3,6,10,42
Frank Jackson,PG,21,NOP,22,1,321,52,140,.371,20,65,.308,32,75,.427,.443,26,32,.813,5,25,30,22,9,1,21,33,150
Jaren Jackson,C,20,MEM,23,23,628,139,304,.457,49,131,.374,90,173,.520,.538,53,67,.791,27,84,111,35,12,28,44,97,380
Justin Jackson,PF,24,DAL,22,0,310,54,116,.466,23,58,.397,31,58,.534,.565,10,13,.769,9,46,55,9,5,2,4,23,141
Reggie Jackson,PG,29,DET,2,2,36,4,11,.364,1,5,.200,3,6,.500,.409,1,1,1.000,1,4,5,8,0,0,1,2,10
Justin James,SG,23,SAC,11,0,140,18,44,.409,3,14,.214,15,30,.500,.443,1,6,.167,2,18,20,9,4,6,5,11,40
LeBron James,PG,35,LAL,25,25,863,250,501,.499,53,149,.356,197,352,.560,.552,93,134,.694,25,150,175,269,33,13,95,44,646
Amile Jefferson,PF,26,ORL,5,0,13,3,3,1.000,0,0,NA,3,3,1.000,1.000,0,0,NA,2,2,4,2,0,0,1,2,6
DaQuan Jeffries,SG,22,SAC,2,0,11,1,1,1.000,0,0,NA,1,1,1.000,1.000,0,0,NA,1,0,1,1,0,0,0,1,2
Ty Jerome,PG,22,PHO,6,0,77,6,24,.250,3,9,.333,3,15,.200,.313,2,2,1.000,0,10,10,13,9,0,6,10,17
Alize Johnson,SF,23,IND,8,0,37,5,11,.455,0,0,NA,5,11,.455,.455,3,4,.750,6,6,12,2,0,0,1,4,13
B.J. Johnson,SF,24,ORL,1,0,3,0,0,NA,0,0,NA,0,0,NA,NA,0,0,NA,0,0,0,0,0,0,0,0,0
Cameron Johnson,PF,23,PHO,22,0,445,70,161,.435,44,108,.407,26,53,.491,.571,19,21,.905,23,46,69,19,13,7,16,38,203
James Johnson,PF,32,MIA,6,0,68,8,18,.444,2,9,.222,6,9,.667,.500,2,4,.500,2,9,11,4,3,2,4,5,20
Keldon Johnson,SF,20,SAS,1,0,2,0,1,.000,0,0,NA,0,1,.000,.000,0,0,NA,0,0,0,0,0,0,0,0,0
Stanley Johnson,PF,23,TOR,5,0,19,3,9,.333,1,4,.250,2,5,.400,.389,0,0,NA,2,5,7,0,1,0,4,6,7
Tyler Johnson,SG,27,PHO,19,3,364,44,111,.396,18,55,.327,26,56,.464,.477,18,24,.750,5,30,35,41,6,6,19,28,124
Nikola Jokić,C,24,DEN,22,22,683,145,310,.468,20,87,.230,125,223,.561,.500,43,54,.796,45,174,219,139,23,13,56,70,353
Damian Jones,C,24,ATL,24,16,446,74,105,.705,2,5,.400,72,100,.720,.714,30,45,.667,38,58,96,17,11,22,16,86,180
Derrick Jones,SF,22,MIA,10,0,167,20,43,.465,2,12,.167,18,31,.581,.488,8,13,.615,6,21,27,9,8,3,6,22,50
Tyus Jones,PG,23,MEM,24,5,483,58,151,.384,8,37,.216,50,114,.439,.411,18,25,.720,0,37,37,114,21,3,30,21,142
DeAndre Jordan,C,31,BRK,21,3,450,70,101,.693,0,0,NA,70,101,.693,.693,32,46,.696,51,147,198,42,8,22,21,45,172
Cory Joseph,PG,28,SAC,24,15,631,57,156,.365,13,47,.277,44,109,.404,.407,16,16,1.000,12,49,61,93,20,13,30,49,143
Mfiondu Kabengele,C,22,LAC,9,0,38,8,19,.421,5,11,.455,3,8,.375,.553,3,3,1.000,1,6,7,1,1,1,1,4,24
Frank Kaminsky,C,26,PHO,24,11,567,94,211,.445,30,86,.349,64,125,.512,.517,47,70,.671,24,102,126,53,10,9,24,54,265
Enes Kanter,C,27,BOS,16,3,253,45,78,.577,0,1,.000,45,77,.584,.577,24,37,.649,40,53,93,18,9,8,12,21,114
Luke Kennard,SG,23,DET,23,20,754,128,286,.448,59,148,.399,69,138,.500,.551,60,67,.896,6,73,79,96,11,5,33,54,375
Stanton Kidd,SF,27,UTA,4,0,15,0,3,.000,0,1,.000,0,2,.000,.000,0,0,NA,0,3,3,1,0,0,2,3,0
Michael Kidd-Gilchrist,PF,26,CHO,5,0,76,11,32,.344,3,11,.273,8,21,.381,.391,4,5,.800,6,13,19,5,0,2,3,11,29
Maxi Kleber,C,28,DAL,22,5,534,59,140,.421,31,84,.369,28,56,.500,.532,28,31,.903,37,88,125,22,5,14,15,40,177
Brandon Knight,PG,28,CLE,8,0,95,14,40,.350,10,31,.323,4,9,.444,.475,2,6,.333,1,7,8,15,4,0,6,9,40
Kevin Knox,SF,20,NYK,24,3,474,58,160,.363,30,88,.341,28,72,.389,.456,31,47,.660,10,59,69,30,11,10,16,38,177
John Konchar,SG,23,MEM,1,0,7,0,0,NA,0,0,NA,0,0,NA,NA,0,0,NA,0,0,0,0,0,0,0,0,0
Furkan Korkmaz,SG,22,PHI,24,11,540,73,172,.424,40,109,.367,33,63,.524,.541,17,21,.810,4,52,56,23,8,5,18,37,203
Luke Kornet,C,24,CHI,14,0,142,15,48,.313,5,27,.185,10,21,.476,.365,5,5,1.000,6,16,22,6,2,10,3,13,40
Kyle Korver,SF,38,MIL,21,0,324,37,101,.366,30,84,.357,7,17,.412,.515,9,11,.818,6,29,35,17,10,4,18,21,113
Rodions Kurucs,PF,21,BRK,10,0,99,9,23,.391,3,7,.429,6,16,.375,.457,2,6,.333,5,17,22,1,5,0,12,16,23
Kyle Kuzma,PF,24,LAL,20,1,461,81,187,.433,32,89,.360,49,98,.500,.519,27,39,.692,8,60,68,17,6,8,35,34,221
Skal Labissière,C,23,POR,25,0,419,62,111,.559,2,9,.222,60,102,.588,.568,15,22,.682,49,78,127,27,6,24,24,65,141
Jeremy Lamb,SG,27,IND,16,16,508,93,201,.463,19,64,.297,74,137,.540,.510,37,46,.804,10,69,79,41,17,9,22,35,242
Romeo Langford,SG,20,BOS,1,0,0,0,0,NA,0,0,NA,0,0,NA,NA,0,0,NA,0,0,0,0,0,0,0,0,0
Zach LaVine,SG,24,CHI,26,26,845,201,461,.436,81,194,.418,120,267,.449,.524,108,134,.806,17,97,114,104,32,13,88,65,591
Jake Layman,PF,25,MIN,14,2,369,61,132,.462,19,54,.352,42,78,.538,.534,6,10,.600,12,29,41,11,12,10,18,31,147
T.J. Leaf,PF,22,IND,15,1,158,26,58,.448,5,11,.455,21,47,.447,.491,5,8,.625,20,37,57,6,7,3,6,14,62
Courtney Lee,SG,34,DAL,7,3,62,13,22,.591,7,12,.583,6,10,.600,.750,0,0,NA,0,3,3,3,0,2,1,5,33
Damion Lee,SG,27,GSW,12,0,256,38,98,.388,12,38,.316,26,60,.433,.449,28,33,.848,9,35,44,20,8,0,13,19,116
Alex Len,C,26,ATL,24,9,413,77,144,.535,7,30,.233,70,114,.614,.559,32,47,.681,35,76,111,24,13,19,21,51,193
Kawhi Leonard,SF,28,LAC,19,19,593,169,374,.452,32,95,.337,137,279,.491,.495,104,121,.860,20,127,147,100,36,14,64,38,474
Meyers Leonard,PF,27,MIA,24,24,436,55,95,.579,21,42,.500,34,53,.642,.689,5,9,.556,8,94,102,23,7,11,18,49,136
Caris LeVert,SG,25,BRK,9,9,284,59,140,.421,13,36,.361,46,104,.442,.468,20,31,.645,10,35,45,36,6,1,31,20,151
Damian Lillard,PG,29,POR,23,23,841,191,426,.448,77,209,.368,114,217,.525,.539,159,174,.914,11,93,104,169,23,10,66,47,618
Nassir Little,PF,19,POR,18,3,270,31,76,.408,5,30,.167,26,46,.565,.441,15,22,.682,20,42,62,12,8,7,9,35,82
Kevon Looney,C,23,GSW,6,2,61,8,20,.400,1,1,1.000,7,19,.368,.425,3,5,.600,10,9,19,2,1,2,4,10,20
Brook Lopez,C,31,MIL,23,23,605,78,200,.390,34,113,.301,44,87,.506,.475,42,46,.913,14,97,111,33,16,53,24,52,232
Robin Lopez,C,31,MIL,25,2,362,52,109,.477,13,44,.295,39,65,.600,.537,10,17,.588,27,44,71,17,4,17,31,43,127
Kevin Love,PF,31,CLE,20,20,606,99,226,.438,40,113,.354,59,113,.522,.527,76,88,.864,21,189,210,52,13,8,55,27,314
Kyle Lowry,PG,33,TOR,13,13,483,72,176,.409,37,107,.346,35,69,.507,.514,67,74,.905,8,54,62,89,15,5,40,37,248
Timothé Luwawu-Cabarrot,SG,24,BRK,2,0,6,0,2,.000,0,1,.000,0,1,.000,.000,1,2,.500,0,0,0,0,0,0,0,0,1
Trey Lyles,PF,24,SAS,23,14,397,38,88,.432,18,48,.375,20,40,.500,.534,5,9,.556,32,108,140,29,7,7,18,27,99
Daryl Macon,SG,24,MIA,4,0,14,1,3,.333,1,2,.500,0,1,.000,.500,0,0,NA,0,0,0,1,0,0,2,1,3
Josh Magette,PG,30,ORL,3,0,10,2,6,.333,0,0,NA,2,6,.333,.333,1,2,.500,1,2,3,2,2,0,3,0,5
Ian Mahinmi,C,33,WAS,3,0,51,9,14,.643,0,1,.000,9,13,.692,.643,7,10,.700,6,8,14,2,1,5,4,8,25
Thon Maker,C,22,DET,22,0,230,23,43,.535,7,14,.500,16,29,.552,.616,16,31,.516,10,27,37,9,6,14,11,31,69
Terance Mann,SG,23,LAC,20,3,169,19,39,.487,2,9,.222,17,30,.567,.513,7,8,.875,3,19,22,23,6,2,12,21,47
Boban Marjanović,C,31,DAL,10,1,131,31,56,.554,0,1,.000,31,55,.564,.554,13,16,.813,15,40,55,7,2,3,9,18,75
Lauri Markkanen,PF,22,CHI,26,26,777,120,305,.393,51,156,.327,69,149,.463,.477,86,106,.811,27,146,173,43,22,13,49,51,377
Caleb Martin,SF,24,CHO,4,0,28,3,10,.300,0,3,.000,3,7,.429,.300,1,3,.333,1,4,5,3,1,2,3,3,7
Cody Martin,SF,24,CHO,18,0,216,18,50,.360,2,21,.095,16,29,.552,.380,16,23,.696,9,31,40,22,13,2,9,22,54
Kelan Martin,SF,24,MIN,9,0,123,15,44,.341,5,24,.208,10,20,.500,.398,0,0,NA,2,24,26,3,1,1,4,20,35
Frank Mason,PG,25,MIL,2,0,10,1,4,.250,1,2,.500,0,2,.000,.375,1,2,.500,0,0,0,2,0,0,0,1,4
Garrison Mathews,SG,23,WAS,2,0,14,0,2,.000,0,2,.000,0,0,NA,.000,0,0,NA,0,1,1,2,0,0,1,3,0
Wesley Matthews,SG,33,MIL,25,25,598,70,157,.446,43,109,.394,27,48,.563,.583,23,27,.852,4,52,56,36,14,2,19,31,206
Patrick McCaw,SF,24,TOR,3,0,50,3,7,.429,1,3,.333,2,4,.500,.500,1,2,.500,2,4,6,3,3,0,4,5,8
CJ McCollum,SG,28,POR,25,25,905,217,488,.445,64,171,.374,153,317,.483,.510,43,53,.811,20,91,111,93,19,22,48,71,541
T.J. McConnell,PG,27,IND,23,0,403,66,138,.478,1,4,.250,65,134,.485,.482,12,13,.923,10,50,60,111,13,5,34,27,145
Jalen McDaniels,PF,22,CHO,1,0,3,1,2,.500,0,0,NA,1,2,.500,.500,0,0,NA,1,0,1,0,0,0,0,0,2
Doug McDermott,PF,28,IND,25,0,516,88,194,.454,44,96,.458,44,98,.449,.567,15,19,.789,12,59,71,28,3,3,20,50,235
JaVale McGee,C,32,LAL,25,25,410,81,129,.628,0,0,NA,81,129,.628,.628,19,28,.679,47,104,151,15,14,28,18,58,181
Rodney McGruder,SG,28,LAC,15,2,260,23,60,.383,11,35,.314,12,25,.480,.475,3,8,.375,11,25,36,12,4,3,7,26,60
Alfonzo McKinnie,SF,27,CLE,17,0,175,17,50,.340,8,25,.320,9,25,.360,.420,7,11,.636,10,26,36,3,6,3,8,20,49
Jordan McLaughlin,PG,23,MIN,4,0,57,4,15,.267,1,8,.125,3,7,.429,.300,2,2,1.000,1,6,7,8,1,0,4,4,11
Ben McLemore,SG,26,HOU,24,7,548,78,196,.398,58,168,.345,20,28,.714,.546,25,29,.862,9,50,59,25,15,7,19,49,239
Jordan McRae,SG,28,WAS,13,0,235,43,91,.473,13,33,.394,30,58,.517,.544,17,19,.895,3,28,31,36,8,4,14,26,116
Nicolò Melli,C,29,NOP,23,3,348,41,102,.402,22,70,.314,19,32,.594,.510,19,24,.792,14,46,60,25,14,4,18,42,123
De'Anthony Melton,PG,21,MEM,13,0,190,27,63,.429,6,18,.333,21,45,.467,.476,16,18,.889,9,33,42,37,15,3,18,21,76
Chimezie Metu,PF,22,SAS,6,0,21,7,12,.583,0,0,NA,7,12,.583,.583,2,4,.500,7,4,11,2,0,2,0,0,16
Khris Middleton,SF,28,MIL,18,15,495,121,247,.490,37,94,.394,84,153,.549,.565,43,48,.896,13,90,103,61,16,2,31,43,322
C.J. Miles,SG,32,WAS,10,0,161,19,59,.322,11,35,.314,8,24,.333,.415,15,20,.750,4,8,12,12,10,4,4,14,64
Malcolm Miller,SF,26,TOR,10,1,57,6,12,.500,5,10,.500,1,2,.500,.708,1,6,.167,0,7,7,4,0,2,2,6,18
Patty Mills,PG,31,SAS,23,1,538,90,196,.459,47,113,.416,43,83,.518,.579,29,37,.784,4,28,32,53,21,4,24,35,256
Paul Millsap,PF,34,DEN,22,22,566,97,203,.478,25,54,.463,72,149,.483,.539,65,74,.878,43,86,129,28,20,18,27,59,284
Shake Milton,SG,23,PHI,9,0,82,12,35,.343,4,19,.211,8,16,.500,.400,7,9,.778,1,7,8,7,1,0,12,13,35
Donovan Mitchell,SG,23,UTA,25,25,866,230,516,.446,56,154,.364,174,362,.481,.500,106,126,.841,22,97,119,92,30,7,59,56,622
Naz Mitrou-Long,SG,26,IND,3,0,43,6,16,.375,2,11,.182,4,5,.800,.438,0,0,NA,0,6,6,7,1,1,2,1,14
Malik Monk,SG,21,CHO,26,0,531,91,208,.438,27,99,.273,64,109,.587,.502,30,36,.833,7,61,68,56,10,6,37,42,239
E'Twaun Moore,SG,30,NOP,16,3,326,59,140,.421,21,55,.382,38,85,.447,.496,14,22,.636,13,38,51,23,8,1,11,27,153
Ja Morant,PG,20,MEM,19,19,551,130,281,.463,19,45,.422,111,236,.470,.496,77,98,.786,16,44,60,122,25,5,62,32,356
Juwan Morgan,PF,22,UTA,3,0,9,0,0,NA,0,0,NA,0,0,NA,NA,0,0,NA,0,2,2,0,0,0,1,1,0
Marcus Morris,SF,30,NYK,23,23,749,141,328,.430,66,135,.489,75,193,.389,.530,88,103,.854,26,109,135,30,22,13,41,71,436
Markieff Morris,PF,30,DET,23,12,507,86,186,.462,35,88,.398,51,98,.520,.556,26,34,.765,12,77,89,35,15,5,38,54,233
Monte Morris,PG,24,DEN,22,0,392,62,146,.425,12,30,.400,50,116,.431,.466,22,30,.733,4,34,38,73,11,7,16,20,158
Johnathan Motley,PF,24,LAC,3,0,7,1,3,.333,1,1,1.000,0,2,.000,.500,0,0,NA,1,1,2,2,1,0,3,1,3
Emmanuel Mudiay,PG,23,UTA,22,0,352,63,134,.470,11,34,.324,52,100,.520,.511,25,31,.806,7,50,57,52,6,6,38,39,162
Dejounte Murray,PG,23,SAS,20,13,452,76,168,.452,5,26,.192,71,142,.500,.467,37,47,.787,25,96,121,81,32,5,45,46,194
Jamal Murray,PG,22,DEN,22,22,694,145,333,.435,36,107,.336,109,226,.482,.489,56,62,.903,17,75,92,100,32,8,48,38,382
Džanan Musa,SF,20,BRK,19,0,294,30,93,.323,9,47,.191,21,46,.457,.371,23,31,.742,9,40,49,24,9,1,23,17,92
Mike Muscala,C,28,OKC,15,0,166,18,58,.310,12,44,.273,6,14,.429,.414,7,8,.875,6,29,35,14,4,3,6,20,55
Sviatoslav Mykhailiuk,SF,22,DET,19,1,324,37,86,.430,29,63,.460,8,23,.348,.599,5,6,.833,4,19,23,25,8,1,17,22,108
Abdel Nader,SF,26,OKC,17,4,296,43,88,.489,21,45,.467,22,43,.512,.608,20,24,.833,6,28,34,9,6,6,17,25,127
Larry Nance,C,27,CLE,22,4,562,80,159,.503,26,69,.377,54,90,.600,.585,25,35,.714,41,119,160,32,19,10,22,35,211
Shabazz Napier,PG,28,MIN,12,0,211,27,72,.375,11,45,.244,16,27,.593,.451,21,24,.875,1,22,23,37,13,3,20,12,86
Raul Neto,PG,27,PHI,22,2,268,39,77,.506,14,28,.500,25,49,.510,.597,3,4,.750,3,21,24,36,9,2,20,13,95
Georges Niang,PF,26,UTA,19,0,222,31,64,.484,17,40,.425,14,24,.583,.617,7,10,.700,2,31,33,9,1,3,10,27,86
Nerlens Noel,C,25,OKC,23,3,428,70,107,.654,0,0,NA,70,107,.654,.654,37,46,.804,32,83,115,34,23,36,24,64,177
Zach Norvell,SG,22,LAL,2,0,5,0,1,.000,0,0,NA,0,1,.000,.000,0,0,NA,0,1,1,0,0,0,0,0,0
Jaylen Nowell,SG,20,MIN,2,0,15,1,4,.250,0,3,.000,1,1,1.000,.250,1,1,1.000,0,1,1,3,0,0,1,1,3
Frank Ntilikina,PG,21,NYK,23,19,569,53,141,.376,19,57,.333,34,84,.405,.443,13,17,.765,8,37,45,73,28,10,29,60,138
Kendrick Nunn,SG,24,MIA,24,24,731,154,341,.452,50,145,.345,104,196,.531,.525,31,38,.816,7,57,64,82,25,7,50,61,389
David Nwaba,SF,27,BRK,16,0,202,26,49,.531,8,18,.444,18,31,.581,.612,12,20,.600,7,27,34,5,6,9,6,25,72
Royce O'Neale,PF,26,UTA,25,23,711,51,112,.455,31,70,.443,20,42,.476,.594,12,14,.857,3,113,116,64,20,6,21,76,145
Kyle O'Quinn,C,29,PHI,14,0,147,23,43,.535,5,13,.385,18,30,.600,.593,2,6,.333,16,38,54,20,2,11,15,22,53
Semi Ojeleye,PF,25,BOS,23,1,349,22,53,.415,12,33,.364,10,20,.500,.528,7,10,.700,8,35,43,10,10,1,5,28,63
Jahlil Okafor,C,24,NOP,16,8,294,56,90,.622,1,2,.500,55,88,.625,.628,27,39,.692,27,46,73,27,5,15,26,48,140
Elie Okobo,PG,22,PHO,16,0,152,21,52,.404,10,25,.400,11,27,.407,.500,11,21,.524,2,13,15,38,4,0,4,8,63
Josh Okogie,SG,21,MIN,22,7,554,62,142,.437,19,56,.339,43,86,.500,.504,59,74,.797,32,79,111,34,23,8,32,50,202
KZ Okpala,SF,20,MIA,3,0,3,0,0,NA,0,0,NA,0,0,NA,NA,0,0,NA,0,1,1,0,0,0,1,0,0
Kelly Olynyk,C,28,MIA,24,0,555,70,156,.449,38,92,.413,32,64,.500,.571,31,35,.886,23,94,117,32,22,9,33,65,209
Miye Oni,SG,22,UTA,3,0,8,0,0,NA,0,0,NA,0,0,NA,NA,0,0,NA,0,1,1,0,0,0,1,0,0
Cedi Osman,SF,24,CLE,24,24,691,79,191,.414,36,102,.353,43,89,.483,.508,21,32,.656,9,71,80,54,26,7,30,53,215
Kelly Oubre,SF,24,PHO,24,24,778,146,329,.444,36,111,.324,110,218,.505,.498,89,113,.788,34,116,150,34,32,21,39,79,417
Jabari Parker,PF,24,ATL,25,20,695,164,327,.502,26,93,.280,138,234,.590,.541,45,63,.714,44,116,160,45,36,14,47,76,399
Chandler Parsons,SF,31,ATL,4,0,43,5,14,.357,4,12,.333,1,2,.500,.500,0,0,NA,1,5,6,2,4,0,2,3,14
Eric Paschall,PF,23,GSW,25,19,772,149,302,.493,17,59,.288,132,243,.543,.522,88,109,.807,35,91,126,42,9,9,40,49,403
Patrick Patterson,PF,30,LAC,23,12,332,39,101,.386,31,77,.403,8,24,.333,.540,12,16,.750,16,51,67,19,4,2,7,19,121
Justin Patton,C,22,OKC,2,0,9,1,3,.333,0,1,.000,1,2,.500,.333,0,0,NA,0,2,2,0,0,0,1,4,2
Chris Paul,PG,34,OKC,24,24,747,124,276,.449,37,103,.359,87,173,.503,.516,91,102,.892,6,96,102,147,38,5,40,57,376
Elfrid Payton,PG,25,NYK,8,3,172,24,59,.407,6,15,.400,18,44,.409,.458,7,8,.875,7,16,23,33,15,1,17,14,61
Norvel Pelle,SF,26,PHI,2,0,25,2,3,.667,0,0,NA,2,3,.667,.667,4,6,.667,2,8,10,2,0,4,2,4,8
Theo Pinson,SG,24,BRK,15,0,224,29,98,.296,10,46,.217,19,52,.365,.347,11,12,.917,8,26,34,34,8,1,22,21,79
Mason Plumlee,C,29,DEN,22,0,365,60,103,.583,0,4,.000,60,99,.606,.583,27,51,.529,37,88,125,49,17,17,36,55,147
Vincent Poirier,C,26,BOS,9,0,44,7,14,.500,0,0,NA,7,14,.500,.500,1,2,.500,8,7,15,3,2,2,3,10,15
Jakob Pöltl,C,24,SAS,23,7,435,60,101,.594,0,0,NA,60,101,.594,.594,19,34,.559,53,86,139,35,14,31,21,42,139
Shamorie Ponds,PG,21,TOR,2,0,8,2,4,.500,0,1,.000,2,3,.667,.500,0,0,NA,0,1,1,2,0,1,0,2,4
Jordan Poole,SG,20,GSW,24,9,576,59,229,.258,29,118,.246,30,111,.270,.321,42,49,.857,4,50,54,49,15,6,29,44,189
Kevin Porter,SF,19,CLE,23,1,489,68,158,.430,19,59,.322,49,99,.495,.491,22,30,.733,8,65,73,45,22,5,37,55,177
Michael Porter,PF,21,DEN,13,0,117,23,52,.442,5,15,.333,18,37,.486,.490,7,10,.700,12,23,35,5,0,3,8,16,58
Otto Porter,SF,26,CHI,9,9,226,35,84,.417,16,40,.400,19,44,.432,.512,15,20,.750,8,23,31,14,9,3,7,20,101
Bobby Portis,C,24,NYK,25,2,546,88,215,.409,24,71,.338,64,144,.444,.465,25,34,.735,38,107,145,27,16,9,23,42,225
Kristaps Porziņģis,PF,24,DAL,22,22,665,129,324,.398,44,130,.338,85,194,.438,.466,59,84,.702,37,155,192,30,12,44,35,64,361
Dwight Powell,C,28,DAL,20,17,506,67,98,.684,6,13,.462,61,85,.718,.714,23,41,.561,31,62,93,25,16,8,19,51,163
Norman Powell,SG,26,TOR,24,13,679,117,247,.474,41,114,.360,76,133,.571,.557,53,64,.828,13,79,92,37,26,8,40,44,328
Julius Randle,PF,25,NYK,25,25,801,153,348,.440,23,88,.261,130,260,.500,.473,95,143,.664,60,158,218,87,18,3,80,71,424
Cam Reddish,SF,20,ATL,22,17,548,66,200,.330,24,89,.270,42,111,.378,.390,33,45,.733,16,70,86,34,19,8,40,41,189
J.J. Redick,SG,35,NOP,24,20,685,116,263,.441,78,174,.448,38,89,.427,.589,66,75,.880,5,68,73,49,10,5,30,38,376
Naz Reid,C,20,MIN,2,0,4,1,2,.500,1,2,.500,0,0,NA,.750,0,0,NA,0,1,1,0,0,0,0,1,3
Josh Richardson,SG,26,PHI,17,17,531,94,212,.443,33,86,.384,61,126,.484,.521,40,50,.800,11,45,56,58,19,10,37,48,261
Austin Rivers,SG,27,HOU,22,1,547,67,162,.414,31,95,.326,36,67,.537,.509,20,28,.714,17,43,60,34,11,4,15,44,185
Duncan Robinson,SF,25,MIA,24,19,641,97,201,.483,75,167,.449,22,34,.647,.669,15,16,.938,3,68,71,21,19,9,16,64,284
Glenn Robinson,SF,26,GSW,26,26,838,121,267,.453,32,85,.376,89,182,.489,.513,30,36,.833,38,84,122,45,26,7,23,45,304
Jerome Robinson,SG,22,LAC,21,0,266,30,91,.330,11,43,.256,19,48,.396,.390,5,10,.500,3,32,35,20,7,7,15,30,76
Justin Robinson,PG,22,WAS,5,0,14,2,5,.400,1,1,1.000,1,4,.250,.500,0,0,NA,1,2,3,2,0,0,2,0,5
Mitchell Robinson,C,21,NYK,21,6,460,78,116,.672,0,0,NA,78,116,.672,.672,42,68,.618,64,77,141,13,14,41,17,71,198
Rajon Rondo,PG,33,LAL,13,0,272,42,91,.462,19,36,.528,23,55,.418,.566,8,11,.727,4,42,46,77,14,1,24,13,111
Derrick Rose,PG,31,DET,19,1,451,122,250,.488,14,43,.326,108,207,.522,.516,47,54,.870,9,29,38,110,15,7,47,21,305
Terrence Ross,SG,28,ORL,22,0,541,101,247,.409,43,133,.323,58,114,.509,.496,42,50,.840,6,57,63,22,22,6,26,38,287
Terry Rozier,PG,25,CHO,27,27,890,165,386,.427,71,177,.401,94,209,.450,.519,67,77,.870,21,104,125,116,31,4,73,59,468
Ricky Rubio,PG,29,PHO,19,19,607,88,226,.389,21,70,.300,67,156,.429,.436,53,63,.841,13,74,87,174,25,3,39,49,250
D'Angelo Russell,SG,23,GSW,14,14,438,112,258,.434,43,119,.361,69,139,.496,.517,51,69,.739,4,47,51,87,11,5,45,27,318
Domantas Sabonis,C,23,IND,23,23,793,165,324,.509,5,26,.192,160,298,.537,.517,84,108,.778,81,230,311,90,18,13,63,85,419
JaKarr Sampson,SF,26,IND,9,7,166,23,41,.561,2,10,.200,21,31,.677,.585,2,7,.286,7,17,24,4,5,6,6,23,50
Dario Šarić,PF,25,PHO,24,24,674,96,224,.429,39,115,.339,57,109,.523,.516,35,41,.854,43,129,172,52,20,10,31,66,266
Tomáš Satoranský,PG,28,CHI,26,26,708,88,198,.444,30,76,.395,58,122,.475,.520,37,42,.881,21,64,85,139,38,3,54,51,243
Admiral Schofield,SF,22,WAS,10,0,76,7,12,.583,4,9,.444,3,3,1.000,.750,4,4,1.000,2,9,11,1,0,0,3,7,22
Dennis Schröder,PG,26,OKC,24,0,706,157,341,.460,38,116,.328,119,225,.529,.516,50,62,.806,8,80,88,81,18,8,63,55,402
Mike Scott,PF,31,PHI,25,1,465,57,132,.432,29,84,.345,28,48,.583,.542,12,15,.800,18,64,82,18,8,2,10,38,155
Thabo Sefolosha,PF,35,HOU,20,0,212,16,46,.348,8,28,.286,8,18,.444,.435,0,1,.000,11,35,46,15,9,4,6,20,40
Collin Sexton,SG,21,CLE,24,24,727,161,370,.435,25,81,.309,136,289,.471,.469,69,85,.812,24,49,73,58,21,1,44,48,416
Landry Shamet,SG,22,LAC,10,10,294,30,77,.390,21,58,.362,9,19,.474,.526,10,10,1.000,0,15,15,17,4,1,12,31,91
Iman Shumpert,SG,29,BRK,13,0,241,21,64,.328,8,33,.242,13,31,.419,.391,4,7,.571,9,25,34,12,12,2,10,21,54
Pascal Siakam,PF,25,TOR,24,24,884,220,481,.457,53,147,.361,167,334,.500,.512,95,116,.819,37,161,198,85,22,19,66,66,588
Chris Silva,PF,23,MIA,22,0,214,29,45,.644,0,2,.000,29,43,.674,.644,24,34,.706,41,44,85,13,5,14,25,56,82
Ben Simmons,PG,23,PHI,23,23,790,134,235,.570,2,5,.400,132,230,.574,.574,51,89,.573,36,124,160,193,51,12,88,76,321
Anfernee Simons,SG,20,POR,25,1,543,94,221,.425,38,107,.355,56,114,.491,.511,31,41,.756,7,43,50,39,11,3,24,51,257
Marcus Smart,SG,25,BOS,20,15,635,82,212,.387,42,126,.333,40,86,.465,.486,29,33,.879,19,48,67,91,26,9,25,46,235
Dennis Smith,PG,22,NYK,17,1,293,34,107,.318,10,33,.303,24,74,.324,.364,14,27,.519,12,21,33,46,7,5,26,37,92
Ish Smith,PG,31,WAS,23,9,581,90,200,.450,21,58,.362,69,142,.486,.503,12,19,.632,11,54,65,100,16,8,28,39,213
Tony Snell,SF,28,DET,20,18,508,56,120,.467,38,85,.447,18,35,.514,.625,4,4,1.000,5,31,36,29,8,2,10,37,154
Omari Spellman,PF,22,GSW,25,0,452,68,156,.436,19,52,.365,49,104,.471,.497,37,44,.841,54,83,137,26,16,16,34,27,192
Max Strus,SG,23,CHI,2,0,6,2,3,.667,0,1,.000,2,2,1.000,.667,1,1,1.000,1,0,1,0,0,0,0,1,5
Edmond Sumner,PG,24,IND,4,2,72,9,19,.474,0,3,.000,9,16,.563,.474,3,5,.600,1,2,3,8,5,1,1,9,21
Caleb Swanigan,PF,22,SAC,4,0,11,1,2,.500,0,0,NA,1,2,.500,.500,1,2,.500,1,3,4,0,1,2,3,3,3
Jayson Tatum,PF,21,BOS,23,23,787,172,418,.411,57,157,.363,115,261,.441,.480,79,95,.832,27,137,164,65,34,17,52,51,480
Jeff Teague,PG,31,MIN,20,12,590,90,197,.457,21,53,.396,69,144,.479,.510,80,92,.870,11,44,55,138,19,6,44,42,281
Garrett Temple,SG,33,BRK,24,15,670,88,211,.417,52,146,.356,36,65,.554,.540,19,25,.760,13,63,76,57,23,13,26,47,247
Daniel Theis,C,27,BOS,20,19,435,56,107,.523,6,19,.316,50,88,.568,.551,21,31,.677,31,96,127,26,9,31,17,63,139
Isaiah Thomas,PG,30,WAS,17,14,424,82,184,.446,34,83,.410,48,101,.475,.538,16,20,.800,3,28,31,86,8,4,37,37,214
Khyri Thomas,SG,23,DET,2,0,6,0,0,NA,0,0,NA,0,0,NA,NA,1,2,.500,0,0,0,0,0,0,0,0,1
Matt Thomas,SG,25,TOR,12,0,136,20,37,.541,14,26,.538,6,11,.545,.730,3,5,.600,1,12,13,4,4,0,4,12,57
Tristan Thompson,C,28,CLE,23,23,720,134,258,.519,3,7,.429,131,251,.522,.525,43,76,.566,93,136,229,54,20,26,40,57,314
Matisse Thybulle,SG,22,PHI,24,3,410,41,92,.446,25,54,.463,16,38,.421,.582,15,20,.750,7,22,29,31,35,17,24,56,122
Anthony Tolliver,PF,34,POR,18,7,287,18,61,.295,14,48,.292,4,13,.308,.410,9,11,.818,10,45,55,11,4,6,11,23,59
Karl-Anthony Towns,C,24,MIN,22,22,744,195,381,.512,77,186,.414,118,195,.605,.613,103,129,.798,59,198,257,98,22,29,67,76,570
Gary Trent,SG,21,POR,12,1,103,15,38,.395,11,26,.423,4,12,.333,.539,0,0,NA,3,12,15,5,3,2,3,8,41
Allonzo Trier,PG,24,NYK,12,1,157,28,55,.509,14,32,.438,14,23,.609,.636,26,33,.788,1,16,17,16,2,3,17,22,96
P.J. Tucker,PF,34,HOU,24,24,858,84,169,.497,47,109,.431,37,60,.617,.636,18,22,.818,38,131,169,34,32,12,26,82,233
Evan Turner,PG,31,ATL,15,0,208,23,59,.390,0,5,.000,23,54,.426,.390,12,14,.857,7,25,32,33,8,8,23,16,58
Myles Turner,C,23,IND,17,17,516,67,160,.419,24,69,.348,43,91,.473,.494,27,36,.750,26,68,94,20,11,40,28,41,185
Jonas Valančiūnas,C,27,MEM,22,22,546,128,224,.571,12,32,.375,116,192,.604,.598,37,48,.771,55,160,215,42,8,18,49,63,305
Denzel Valentine,SF,26,CHI,12,0,143,31,66,.470,18,43,.419,13,23,.565,.606,2,2,1.000,2,22,24,16,8,4,4,14,82
Jarred Vanderbilt,SF,20,DEN,3,0,9,0,0,NA,0,0,NA,0,0,NA,NA,0,0,NA,0,2,2,1,0,0,1,0,0
Fred VanVleet,PG,25,TOR,22,22,806,126,308,.409,58,147,.395,68,161,.422,.503,85,97,.876,4,79,83,155,44,3,52,51,395
Noah Vonleh,C,24,MIN,16,1,181,20,43,.465,1,10,.100,19,33,.576,.477,16,19,.842,18,36,54,16,4,3,13,20,57
Nikola Vučević,C,29,ORL,14,14,431,95,211,.450,16,50,.320,79,161,.491,.488,33,39,.846,41,121,162,49,9,15,20,27,239
Dean Wade,PF,23,CLE,3,0,18,1,2,.500,1,1,1.000,0,1,.000,.750,0,0,NA,0,2,2,0,1,0,0,3,3
Moritz Wagner,C,22,WAS,21,4,429,93,160,.581,22,56,.393,71,104,.683,.650,36,43,.837,34,93,127,28,15,13,43,81,244
Kemba Walker,PG,29,BOS,22,22,706,166,385,.431,82,201,.408,84,184,.457,.538,88,98,.898,21,75,96,114,22,12,48,37,502
Lonnie Walker,SG,21,SAS,16,0,128,27,62,.435,6,16,.375,21,46,.457,.484,5,13,.385,6,15,21,8,4,2,7,11,65
Tyrone Wallace,SG,25,ATL,14,0,160,14,44,.318,1,15,.067,13,29,.448,.330,11,17,.647,3,19,22,13,7,1,10,19,40
Taurean Waller-Prince,SF,25,BRK,24,24,735,113,284,.398,64,163,.393,49,121,.405,.511,24,33,.727,19,128,147,54,21,9,51,63,314
Derrick Walton,PG,24,LAC,10,0,68,6,12,.500,3,8,.375,3,4,.750,.625,3,3,1.000,2,2,4,5,2,0,1,7,18
Brad Wanamaker,PG,30,BOS,23,0,415,56,120,.467,12,30,.400,44,90,.489,.517,48,55,.873,11,38,49,64,17,6,29,39,172
T.J. Warren,SF,26,IND,25,25,822,182,357,.510,32,80,.400,150,277,.542,.555,60,74,.811,17,68,85,26,27,7,35,70,456
PJ Washington,PF,21,CHO,27,27,786,121,247,.490,39,93,.419,82,154,.532,.569,49,69,.710,25,112,137,47,27,23,36,76,330
Yuta Watanabe,SG,25,MEM,3,0,11,3,5,.600,1,1,1.000,2,4,.500,.700,0,0,NA,0,2,2,0,0,1,0,1,7
Tremont Waters,PG,22,BOS,1,0,20,2,7,.286,1,5,.200,1,2,.500,.357,2,2,1.000,0,2,2,3,1,2,2,2,7
Russell Westbrook,PG,31,HOU,22,22,759,184,436,.422,26,113,.230,158,323,.489,.452,100,133,.752,36,141,177,163,38,8,98,85,494
Coby White,SG,19,CHI,26,0,657,114,312,.365,51,151,.338,63,161,.391,.447,38,48,.792,7,88,95,65,18,1,38,36,317
Derrick White,SG,25,SAS,21,9,501,71,157,.452,20,51,.392,51,106,.481,.516,41,52,.788,11,37,48,61,9,15,26,50,203
Hassan Whiteside,C,30,POR,22,22,618,139,228,.610,0,0,NA,139,228,.610,.610,61,80,.763,81,194,275,30,10,52,43,63,339
Andrew Wiggins,SF,24,MIN,20,20,695,185,407,.455,44,131,.336,141,276,.511,.509,77,106,.726,25,79,104,67,14,24,39,47,491
Grant Williams,PF,21,BOS,22,1,308,15,60,.250,1,26,.038,14,34,.412,.258,14,17,.824,15,34,49,18,8,12,17,44,45
Kenrich Williams,PF,25,NOP,23,13,580,44,112,.393,21,73,.288,23,39,.590,.487,9,22,.409,37,99,136,42,20,17,18,59,118
Lou Williams,SG,33,LAC,26,3,807,170,413,.412,45,129,.349,125,284,.440,.466,133,158,.842,12,72,84,162,14,4,80,41,518
Marvin Williams,PF,33,CHO,24,0,487,63,127,.496,30,75,.400,33,52,.635,.614,27,30,.900,9,57,66,23,16,10,16,40,183
Robert Williams,C,22,BOS,19,1,269,33,49,.673,0,0,NA,33,49,.673,.673,8,14,.571,23,64,87,21,17,21,16,34,74
Nigel Williams-Goss,PG,25,UTA,7,0,22,0,5,.000,0,1,.000,0,4,.000,.000,2,2,1.000,1,1,2,2,0,1,1,1,2
D.J. Wilson,PF,23,MIL,12,0,138,23,48,.479,10,31,.323,13,17,.765,.583,1,1,1.000,4,22,26,10,0,1,7,12,57
Justise Winslow,SF,23,MIA,10,5,337,50,127,.394,6,26,.231,44,101,.436,.417,18,27,.667,16,55,71,43,6,4,23,36,124
Christian Wood,PF,24,DET,22,0,331,73,117,.624,15,31,.484,58,86,.674,.688,36,55,.655,27,72,99,12,7,18,21,21,197
Delon Wright,SG,27,DAL,22,2,466,62,129,.481,13,37,.351,49,92,.533,.531,28,34,.824,17,58,75,74,25,7,15,27,165
Thaddeus Young,PF,31,CHI,25,0,541,90,219,.411,28,82,.341,62,137,.453,.475,17,30,.567,38,71,109,43,25,7,40,43,225
Trae Young,PG,21,ATL,24,24,834,219,483,.453,80,213,.376,139,270,.515,.536,151,176,.858,11,86,97,207,30,1,119,36,669
Cody Zeller,C,27,CHO,24,17,560,109,201,.542,14,42,.333,95,159,.597,.577,40,59,.678,68,116,184,28,14,11,39,60,272
Ante Žižić,C,23,CLE,8,0,85,13,26,.500,0,0,NA,13,26,.500,.500,5,6,.833,7,14,21,0,2,2,1,9,31
Ivica Zubac,C,22,LAC,26,24,435,83,142,.585,0,2,.000,83,140,.593,.585,52,63,.825,64,110,174,24,5,29,24,62,218
