Player,Pos,Age,Tm,G,GS,MP,FG,FGA,FG%,3P,3PA,3P%,2P,2PA,2P%,eFG%,FT,FTA,FT%,ORB,DRB,TRB,AST,STL,BLK,TOV,PF,PTS
Steven Adams,C,26,OKC,22,22,600,106,174,.609,0,1,.000,106,173,.613,.609,34,66,.515,71,139,210,62,10,29,31,43,246
Bam Adebayo,C,22,MIA,26,26,878,149,255,.584,1,8,.125,148,247,.599,.586,97,149,.651,67,209,276,120,36,31,75,70,396
LaMarcus Aldridge,C,34,SAS,23,23,768,174,348,.500,13,38,.342,161,310,.519,.519,71,87,.816,47,117,164,55,14,41,37,51,432
Nickeil Alexander-Walker,SG,21,NOP,22,0,301,49,148,.331,27,79,.342,22,69,.319,.422,11,16,.688,4,43,47,40,9,2,24,27,136
Grayson Allen,SG,24,MEM,13,0,246,38,92,.413,15,43,.349,23,49,.469,.495,15,17,.882,2,36,38,19,5,1,15,21,106
Jarrett Allen,C,21,BRK,26,23,683,125,190,.658,0,1,.000,125,189,.661,.658,70,115,.609,96,175,271,31,18,32,29,63,320
Kadeem Allen,SG,27,NYK,1,0,16,3,6,.500,3,4,.750,0,2,.000,.750,0,0,0,0,0,0,2,1,0,1,1,9
Al-Farouq Aminu,PF,29,ORL,18,2,380,25,86,.291,9,36,.250,16,50,.320,.343,19,29,.655,24,63,87,21,18,8,17,27,78
Kyle Anderson,PF,26,MEM,20,1,405,51,106,.481,4,17,.235,47,89,.528,.500,18,30,.600,21,70,91,50,15,13,19,34,124
Ryan Anderson,PF,31,HOU,2,0,14,2,7,.286,1,5,.200,1,2,.500,.357,0,0,0,0,7,7,2,1,0,1,1,5
Giannis Antetokounmpo,PF,25,MIL,26,26,809,299,531,.563,43,131,.328,256,400,.640,.604,166,280,.593,68,264,332,139,33,32,96,82,807
Kostas Antetokounmpo,PF,22,LAL,2,0,3,0,0,0,0,0,0,0,0,0,0,0,0,0,0,1,1,0,0,0,0,0,0
Thanasis Antetokounmpo,SF,27,MIL,5,0,25,6,10,.600,0,0,0,6,10,.600,.600,2,4,.500,3,0,3,4,0,0,2,3,14
Carmelo Anthony,PF,35,POR,12,12,379,73,176,.415,19,48,.396,54,128,.422,.469,30,37,.811,10,61,71,16,15,5,26,36,195
OG Anunoby,SF,22,TOR,24,24,714,104,209,.498,36,91,.396,68,118,.576,.584,20,33,.606,24,107,131,41,31,22,29,57,264
Ryan Arcidiacono,PG,25,CHI,28,0,443,36,99,.364,24,61,.393,12,38,.316,.485,17,22,.773,14,31,45,42,13,2,17,53,113
Trevor Ariza,SF,34,SAC,19,0,435,32,88,.364,22,64,.344,10,24,.417,.489,10,13,.769,10,62,72,24,19,6,17,31,96
D.J. Augustin,PG,32,ORL,26,6,666,80,211,.379,27,88,.307,53,123,.431,.443,59,66,.894,12,51,63,124,19,0,37,31,246
Deandre Ayton,C,21,PHO,1,1,33,9,14,.643,0,0,0,9,14,.643,.643,0,0,0,3,8,11,0,1,4,0,2,18
Dwayne Bacon,SG,24,CHO,21,10,386,49,156,.314,10,43,.233,39,113,.345,.346,22,31,.710,9,43,52,25,15,2,19,32,130
Marvin Bagley,PF,20,SAC,4,1,94,23,52,.442,1,4,.250,22,48,.458,.452,5,8,.625,10,19,29,2,1,4,6,11,52
Lonzo Ball,PG,22,NOP,19,12,534,70,187,.374,38,112,.339,32,75,.427,.476,13,22,.591,17,67,84,105,23,6,49,37,191
Mo Bamba,C,21,ORL,24,0,376,58,130,.446,19,49,.388,39,81,.481,.519,10,15,.667,34,90,124,11,6,31,27,48,145
J.J. Barea,PG,35,DAL,7,0,97,25,56,.446,12,22,.545,13,34,.382,.554,2,2,1.000,2,10,12,22,2,1,5,5,64
Harrison Barnes,PF,27,SAC,26,26,921,143,308,.464,35,99,.354,108,209,.517,.521,95,119,.798,27,110,137,61,22,5,40,32,416
RJ Barrett,SG,19,NYK,26,26,839,133,347,.383,26,89,.292,107,258,.415,.421,65,119,.546,28,110,138,78,31,12,59,61,357
Will Barton,SF,29,DEN,23,23,749,131,286,.458,43,104,.413,88,182,.484,.533,39,54,.722,37,120,157,78,26,10,29,49,344
Keita Bates-Diop,SF,24,MIN,13,0,241,35,68,.515,17,36,.472,18,32,.563,.640,6,10,.600,6,28,34,8,4,6,5,13,93
Nicolas Batum,SF,31,CHO,14,0,306,16,46,.348,9,33,.273,7,13,.538,.446,5,5,1.000,16,43,59,43,11,7,19,26,46
Aron Baynes,C,33,PHO,16,12,367,85,157,.541,28,72,.389,57,85,.671,.631,30,41,.732,26,65,91,40,4,12,19,65,228
Kent Bazemore,SF,30,POR,26,5,604,66,192,.344,32,95,.337,34,97,.351,.427,38,47,.809,10,99,109,42,22,18,36,77,202
Darius Bazley,PF,19,OKC,25,1,413,34,91,.374,15,44,.341,19,47,.404,.456,13,20,.650,8,83,91,12,8,11,20,23,96
Bradley Beal,SG,26,WAS,24,24,884,226,510,.443,63,189,.333,163,321,.508,.505,145,176,.824,28,86,114,166,25,6,87,66,660
Malik Beasley,SG,23,DEN,18,0,283,43,113,.381,22,54,.407,21,59,.356,.478,6,7,.857,5,21,26,18,8,2,17,19,114
Marco Belinelli,SG,33,SAS,23,0,368,44,131,.336,22,64,.344,22,67,.328,.420,17,23,.739,1,37,38,32,5,0,9,17,127
Jordan Bell,C,25,MIN,15,0,150,20,36,.556,0,5,.000,20,31,.645,.556,14,23,.609,16,35,51,10,1,7,14,11,54
DeAndre' Bembry,SG,25,ATL,26,4,610,73,150,.487,9,38,.237,64,112,.571,.517,18,37,.486,25,82,107,63,34,12,39,52,173
Dragan Bender,SF,22,MIL,3,0,29,6,8,.750,2,4,.500,4,4,1.000,.875,1,1,1.000,0,2,2,3,0,2,1,6,15
Dāvis Bertāns,PF,27,WAS,24,1,691,122,262,.466,93,204,.456,29,58,.500,.643,32,36,.889,22,88,110,38,15,16,15,62,369
Patrick Beverley,PG,31,LAC,24,24,707,69,172,.401,34,103,.330,35,69,.507,.500,14,23,.609,33,118,151,77,35,13,35,87,186
Khem Birch,C,27,ORL,16,11,375,28,57,.491,0,1,.000,28,56,.500,.491,13,26,.500,33,57,90,18,10,13,11,41,69
Goga Bitadze,C,20,IND,21,2,229,27,58,.466,4,14,.286,23,44,.523,.500,14,19,.737,17,36,53,15,1,21,11,36,72
Bismack Biyombo,C,27,CHO,27,12,481,82,144,.569,0,0,0,82,144,.569,.569,49,83,.590,58,88,146,23,6,20,17,57,213
Nemanja Bjelica,PF,31,SAC,26,25,680,113,238,.475,48,111,.432,65,127,.512,.576,19,21,.905,46,120,166,73,25,14,43,76,293
Eric Bledsoe,PG,30,MIL,26,26,693,147,308,.477,32,93,.344,115,215,.535,.529,65,80,.813,21,107,128,147,22,12,60,60,391
Bogdan Bogdanović,SG,27,SAC,24,0,664,126,294,.429,65,163,.399,61,131,.466,.539,37,53,.698,7,61,68,95,28,2,49,47,354
Bojan Bogdanović,SF,30,UTA,25,25,832,172,383,.449,82,180,.456,90,203,.443,.556,93,106,.877,16,93,109,50,17,4,72,47,519
Jonah Bolden,PF,24,PHI,2,0,5,1,1,1.000,0,0,0,1,1,1.000,1.000,0,2,.000,0,0,0,0,1,0,1,0,2
Jordan Bone,PG,22,DET,3,0,6,2,5,.400,0,1,.000,2,4,.500,.400,0,0,0,0,0,0,0,0,0,2,2,4
Isaac Bonga,SF,20,WAS,19,13,305,25,55,.455,4,16,.250,21,39,.538,.491,12,15,.800,14,33,47,24,12,5,11,40,66
Devin Booker,SG,23,PHO,24,24,861,213,420,.507,54,133,.406,159,287,.554,.571,121,134,.903,15,79,94,154,15,8,91,72,601
Chris Boucher,PF,27,TOR,22,0,255,41,92,.446,11,35,.314,30,57,.526,.505,20,29,.690,41,47,88,10,7,16,8,28,113
Brian Bowen,SG,21,IND,3,0,10,1,4,.250,0,1,.000,1,3,.333,.250,0,0,0,0,1,1,0,0,1,0,0,2
Ky Bowman,PG,22,GSW,26,6,596,88,194,.454,27,65,.415,61,129,.473,.523,20,22,.909,13,56,69,70,23,3,31,55,223
Avery Bradley,SG,29,LAL,13,10,334,48,103,.466,8,34,.235,40,69,.580,.505,7,10,.700,8,29,37,19,13,1,15,35,111
Tony Bradley,C,22,UTA,18,2,164,33,54,.611,0,0,0,33,54,.611,.611,11,16,.688,25,38,63,5,2,8,8,28,77
Jarrell Brantley,PF,23,UTA,2,0,9,0,0,0,0,0,0,0,0,0,0,0,0,0,0,4,4,1,0,2,1,1,0
Ignas Brazdeikis,SF,21,NYK,7,0,47,5,20,.250,1,8,.125,4,12,.333,.275,3,4,.750,2,3,5,2,0,1,2,3,14
Mikal Bridges,SF,23,PHO,25,1,538,63,127,.496,12,41,.293,51,86,.593,.543,37,48,.771,22,76,98,30,34,8,21,47,175
Miles Bridges,SF,21,CHO,29,29,909,142,327,.434,49,132,.371,93,195,.477,.509,39,51,.765,37,116,153,51,14,22,48,62,372
Oshae Brissett,SF,21,TOR,5,0,18,1,3,.333,1,1,1.000,0,2,.000,.500,0,0,0,0,1,1,1,1,0,2,1,3
Ryan Broekhoff,SG,29,DAL,5,0,27,4,8,.500,4,5,.800,0,3,.000,.750,0,0,0,0,6,6,3,1,0,2,1,12
Malcolm Brogdon,PG,27,IND,23,23,722,156,331,.471,34,98,.347,122,233,.524,.523,94,101,.931,15,89,104,176,22,4,63,48,440
Dillon Brooks,SG,24,MEM,26,26,720,137,333,.411,46,126,.365,91,207,.440,.480,58,71,.817,26,61,87,52,30,9,37,98,378
Bruce Brown,SG,23,DET,26,22,685,79,182,.434,13,41,.317,66,141,.468,.470,29,49,.592,23,92,115,96,28,13,45,71,200
Charlie Brown,SG,22,ATL,4,0,16,1,3,.333,1,1,1.000,0,2,.000,.500,4,4,1.000,2,1,3,0,0,1,0,0,7
Jaylen Brown,SF,23,BOS,21,21,709,154,308,.500,40,107,.374,114,201,.567,.565,58,79,.734,21,124,145,47,23,7,38,71,406
Moses Brown,C,20,POR,4,0,15,3,7,.429,0,0,0,3,7,.429,.429,2,4,.500,2,7,9,0,1,0,1,4,8
Sterling Brown,SF,24,MIL,19,0,322,39,95,.411,20,50,.400,19,45,.422,.516,13,19,.684,13,73,86,25,13,2,18,23,111
Troy Brown,SG,20,WAS,21,11,473,65,141,.461,9,37,.243,56,104,.538,.493,25,32,.781,29,77,106,49,29,3,22,30,164
Jalen Brunson,PG,23,DAL,25,3,410,78,159,.491,18,52,.346,60,107,.561,.547,23,33,.697,13,49,62,71,11,0,25,33,197
Thomas Bryant,C,22,WAS,18,18,511,101,184,.549,10,35,.286,91,149,.611,.576,39,53,.736,42,111,153,48,8,18,24,44,251
Trey Burke,PG,27,PHI,10,0,158,27,63,.429,7,18,.389,20,45,.444,.484,8,11,.727,6,9,15,31,7,1,5,7,69
Alec Burks,SG,28,GSW,25,11,728,129,300,.430,36,101,.356,93,199,.467,.490,91,103,.883,20,91,111,73,28,6,40,55,385
Deonte Burton,SG,26,OKC,12,0,101,13,33,.394,5,17,.294,8,16,.500,.470,3,4,.750,3,18,21,4,1,1,4,11,34
Jimmy Butler,SF,30,MIA,22,22,782,136,317,.429,22,80,.275,114,237,.481,.464,168,203,.828,42,102,144,149,47,15,56,30,462
Bruno Caboclo,SF,24,MEM,17,0,179,28,65,.431,4,23,.174,24,42,.571,.462,2,3,.667,16,24,40,8,9,12,7,21,62
Kentavious Caldwell-Pope,SG,26,LAL,27,17,665,87,190,.458,32,83,.386,55,107,.514,.542,26,34,.765,16,41,57,48,22,4,25,45,232
Vlatko Čančar,SF,22,DEN,1,0,2,0,0,0,0,0,0,0,0,0,0,0,0,0,0,0,0,0,0,0,0,0,0
Clint Capela,C,25,HOU,22,22,723,138,217,.636,0,0,0,138,217,.636,.636,28,61,.459,94,230,324,21,18,43,34,61,304
DeMarre Carroll,SF,33,SAS,11,0,120,7,25,.280,3,12,.250,4,13,.308,.340,10,14,.714,7,22,29,10,2,2,9,17,27
Jevon Carter,PG,24,PHO,16,2,225,22,55,.400,14,34,.412,8,21,.381,.527,4,4,1.000,3,24,27,28,13,5,15,24,62
Vince Carter,SF,43,ATL,22,0,347,46,129,.357,24,84,.286,22,45,.489,.450,7,10,.700,4,38,42,22,8,6,14,38,123
Wendell Carter,C,20,CHI,28,28,831,130,230,.565,2,16,.125,128,214,.598,.570,74,103,.718,97,177,274,28,23,24,40,114,336
Michael Carter-Williams,SG,28,ORL,16,0,260,27,79,.342,7,27,.259,20,52,.385,.386,22,31,.710,17,34,51,34,13,8,16,23,83
Alex Caruso,PG,25,LAL,25,0,508,51,115,.443,18,51,.353,33,64,.516,.522,16,24,.667,5,49,54,44,26,7,26,39,136
Willie Cauley-Stein,C,26,GSW,25,24,568,88,160,.550,0,0,0,88,160,.550,.550,22,34,.647,37,122,159,38,31,33,25,72,198
Tyson Chandler,C,37,HOU,18,4,163,13,17,.765,0,0,0,13,17,.765,.765,5,9,.556,19,30,49,6,5,7,6,24,31
Wilson Chandler,F,32,BRK,1,0,19,1,1,1.000,0,0,0,1,1,1.000,1.000,0,0,0,0,7,7,2,1,1,0,3,2
Zylan Cheatham,SF,24,NOP,2,0,20,1,4,.250,0,1,.000,1,3,.333,.250,0,0,0,0,3,3,1,0,0,1,3,2
Chris Chiozza,PG,24,WAS,10,0,123,10,34,.294,7,16,.438,3,18,.167,.397,0,0,0,0,15,15,28,10,2,9,12,27
Marquese Chriss,PF,22,GSW,27,1,482,70,148,.473,4,20,.200,66,128,.516,.486,51,63,.810,44,97,141,53,19,27,38,54,195
Gary Clark,PF,25,HOU,11,0,132,15,39,.385,11,33,.333,4,6,.667,.526,3,3,1.000,7,18,25,8,1,5,1,11,44
Brandon Clarke,PF,23,MEM,20,2,427,108,166,.651,13,25,.520,95,141,.674,.690,24,30,.800,24,93,117,23,9,19,21,35,253
Jordan Clarkson,SG,27,CLE,26,0,588,126,293,.430,51,144,.354,75,149,.503,.517,68,76,.895,18,41,59,66,16,7,37,30,371
Nicolas Claxton,PF,20,BRK,9,0,119,11,21,.524,0,5,.000,11,16,.688,.524,5,12,.417,8,14,22,11,1,5,6,10,27
Chris Clemons,SG,22,HOU,19,0,162,33,77,.429,24,62,.387,9,15,.600,.584,3,4,.750,2,12,14,6,5,3,8,16,93
John Collins,PF,22,ATL,5,5,161,32,61,.525,9,19,.474,23,42,.548,.598,12,17,.706,10,34,44,8,5,10,7,17,85
Zach Collins,PF,22,POR,3,3,86,9,19,.474,3,7,.429,6,12,.500,.553,6,6,1.000,4,8,12,6,0,2,6,11,27
Mike Conley,PG,32,UTA,21,21,628,97,263,.369,40,107,.374,57,156,.365,.445,58,73,.795,16,57,73,96,15,4,44,45,292
Pat Connaughton,SG,27,MIL,25,0,437,49,100,.490,18,55,.327,31,45,.689,.580,13,17,.765,12,86,98,47,8,12,16,24,129
Quinn Cook,PG,26,LAL,20,0,267,42,98,.429,12,35,.343,30,63,.476,.490,4,5,.800,4,19,23,30,6,1,16,12,100
Tyler Cook,PF,22,CLE,6,0,17,5,6,.833,0,0,0,5,6,.833,.833,2,2,1.000,3,2,5,0,1,0,1,1,12
Robert Covington,PF,29,MIN,24,24,674,101,226,.447,50,140,.357,51,86,.593,.558,47,53,.887,17,110,127,26,34,20,38,75,299
Allen Crabbe,SG,27,ATL,15,1,298,32,82,.390,16,53,.302,16,29,.552,.488,7,9,.778,7,30,37,15,9,3,7,16,87
Torrey Craig,SF,29,DEN,18,2,249,23,58,.397,7,27,.259,16,31,.516,.457,6,11,.545,12,30,42,15,6,12,6,33,59
Jae Crowder,SF,29,MEM,25,25,778,87,229,.380,53,163,.325,34,66,.515,.496,43,57,.754,17,138,155,71,25,9,37,53,270
Jarrett Culver,SG,20,MIN,25,15,582,85,229,.371,23,92,.250,62,137,.453,.421,23,53,.434,27,56,83,55,21,12,31,51,216
Seth Curry,SG,29,DAL,23,9,497,70,153,.458,37,92,.402,33,61,.541,.578,31,34,.912,11,37,48,40,14,4,20,41,208
Stephen Curry,PG,31,GSW,4,4,112,27,66,.409,9,37,.243,18,29,.621,.477,18,18,1.000,4,16,20,26,5,2,15,10,81
Troy Daniels,SG,28,LAL,20,0,278,34,92,.370,24,69,.348,10,23,.435,.500,4,7,.571,4,24,28,7,7,1,6,14,96
Anthony Davis,PF,26,LAL,26,26,901,250,501,.499,30,94,.319,220,407,.541,.529,182,212,.858,63,180,243,85,38,68,60,63,712
Ed Davis,C,30,UTA,14,0,170,10,21,.476,0,0,0,10,21,.476,.476,3,7,.429,15,48,63,6,6,7,10,35,23
Terence Davis,SG,22,TOR,25,0,388,58,127,.457,27,68,.397,31,59,.525,.563,16,17,.941,15,56,71,45,12,6,21,43,159
Dewayne Dedmon,C,30,SAC,21,4,305,42,103,.408,11,48,.229,31,55,.564,.461,11,13,.846,26,59,85,8,9,11,31,55,106
Matthew Dellavedova,PG,29,CLE,24,0,319,21,73,.288,5,42,.119,16,31,.516,.322,15,16,.938,7,25,32,56,9,1,17,38,62
DeMar DeRozan,SF,30,SAS,25,25,860,204,404,.505,5,15,.333,199,389,.512,.511,118,149,.792,15,125,140,118,24,12,63,74,531
Cheick Diallo,C,23,PHO,17,0,174,41,59,.695,1,1,1.000,40,58,.690,.703,15,17,.882,14,38,52,9,2,4,8,20,98
Hamidou Diallo,SF,21,OKC,12,1,256,46,92,.500,2,13,.154,44,79,.557,.511,11,18,.611,14,32,46,10,18,4,14,29,105
Gorgui Dieng,C,30,MIN,21,2,260,36,86,.419,9,30,.300,27,56,.482,.471,12,16,.750,17,66,83,21,14,21,14,31,93
Spencer Dinwiddie,SG,26,BRK,26,15,780,181,421,.430,49,157,.312,132,264,.500,.488,135,162,.833,5,69,74,162,23,12,69,88,546
Donte DiVincenzo,SG,23,MIL,24,11,509,78,176,.443,30,85,.353,48,91,.527,.528,24,30,.800,18,80,98,42,36,3,28,40,210
Luka Dončić,PG,20,DAL,25,25,804,236,491,.481,76,233,.326,160,258,.620,.558,184,229,.803,32,207,239,222,30,3,109,57,732
Luguentz Dort,SG,20,OKC,5,0,81,5,16,.313,0,9,.000,5,7,.714,.313,3,5,.600,0,7,7,2,2,0,2,12,13
Damyean Dotson,SG,25,NYK,23,0,360,51,125,.408,24,76,.316,27,49,.551,.504,10,14,.714,4,35,39,25,10,4,11,20,136
Sekou Doumbouya,SF,19,DET,4,0,11,3,6,.500,0,1,.000,3,5,.600,.500,0,1,.000,0,2,2,0,0,0,0,3,6
Goran Dragić,PG,33,MIA,18,1,517,97,208,.466,39,96,.406,58,112,.518,.560,54,76,.711,6,52,58,90,12,4,47,32,287
Andre Drummond,C,26,DET,25,25,845,185,339,.546,0,13,.000,185,326,.567,.546,72,114,.632,115,301,416,73,43,46,89,96,442
Jared Dudley,SF,34,LAL,18,0,155,9,21,.429,9,15,.600,0,6,.000,.643,2,2,1.000,2,14,16,12,8,1,2,17,29
Kris Dunn,PG,25,CHI,28,9,618,81,193,.420,12,61,.197,69,132,.523,.451,15,21,.714,15,80,95,82,54,12,29,99,189
Carsen Edwards,SG,21,BOS,21,0,236,27,84,.321,17,51,.333,10,33,.303,.423,11,13,.846,5,31,36,17,7,2,12,22,82
Henry Ellenson,PF,23,BRK,3,0,10,1,5,.200,0,2,.000,1,3,.333,.200,0,0,0,2,2,4,0,0,0,0,1,2
Wayne Ellington,SG,32,NYK,18,1,257,26,81,.321,21,69,.304,5,12,.417,.451,4,6,.667,1,28,29,16,5,2,12,20,77
Joel Embiid,C,25,PHI,22,22,675,159,345,.461,24,76,.316,135,269,.502,.496,159,196,.811,53,218,271,73,20,29,72,77,501
James Ennis,SF,29,PHI,28,0,491,69,140,.493,26,63,.413,43,77,.558,.586,36,47,.766,30,62,92,27,14,9,18,57,200
Drew Eubanks,PF,22,SAS,4,0,31,5,10,.500,0,0,0,5,10,.500,.500,1,1,1.000,5,8,13,2,0,1,4,4,11
Jacob Evans,SG,22,GSW,7,0,107,12,35,.343,6,10,.600,6,25,.240,.429,10,10,1.000,1,7,8,6,1,3,4,12,40
Dante Exum,SG,24,UTA,11,0,83,10,23,.435,2,6,.333,8,17,.471,.478,2,2,1.000,3,9,12,7,1,2,10,8,24
Tacko Fall,C,24,BOS,1,0,4,2,4,.500,0,0,0,2,4,.500,.500,0,0,0,0,3,3,0,0,0,1,2,4
Derrick Favors,C,28,NOP,11,9,224,41,71,.577,1,2,.500,40,69,.580,.585,2,7,.286,36,57,93,22,6,5,16,25,85
Terrance Ferguson,SF,21,OKC,19,19,497,39,92,.424,23,65,.354,16,27,.593,.549,7,9,.778,11,25,36,19,10,6,14,57,108
Bruno Fernando,C,21,ATL,26,0,299,41,77,.532,4,16,.250,37,61,.607,.558,18,27,.667,28,48,76,27,6,9,23,39,104
Yogi Ferrell,PG,26,SAC,22,0,301,43,97,.443,9,34,.265,34,63,.540,.490,28,32,.875,4,27,31,38,10,1,16,17,123
Dorian Finney-Smith,PF,26,DAL,25,22,686,76,163,.466,30,90,.333,46,73,.630,.558,25,36,.694,46,81,127,31,15,10,24,50,207
Bryn Forbes,SG,26,SAS,25,25,652,106,265,.400,55,160,.344,51,105,.486,.504,31,37,.838,8,54,62,49,12,0,17,47,298
Evan Fournier,SG,27,ORL,26,26,794,182,378,.481,76,170,.447,106,208,.510,.582,81,97,.835,4,69,73,84,25,4,51,59,521
De'Aaron Fox,PG,22,SAC,9,9,288,55,128,.430,10,30,.333,45,98,.459,.469,44,62,.710,5,31,36,63,7,5,37,27,164
Melvin Frazier,SG,23,ORL,5,0,15,2,9,.222,1,3,.333,1,6,.167,.278,0,0,0,1,0,1,1,0,0,0,3,5
Tim Frazier,PG,29,DET,14,4,140,9,43,.209,3,14,.214,6,29,.207,.244,13,16,.813,4,9,13,40,8,2,12,18,34
Markelle Fultz,PG,21,ORL,25,20,644,119,250,.476,9,40,.225,110,210,.524,.494,44,57,.772,11,57,68,106,30,5,45,51,291
Wenyen Gabriel,PF,22,SAC,7,0,47,5,16,.313,1,8,.125,4,8,.500,.344,5,9,.556,4,4,8,3,2,2,3,6,16
Daniel Gafford,C,21,CHI,18,0,199,36,49,.735,0,0,0,36,49,.735,.735,10,21,.476,14,17,31,4,1,21,3,31,82
Danilo Gallinari,PF,31,OKC,24,24,731,129,302,.427,64,165,.388,65,137,.474,.533,101,111,.910,12,126,138,51,17,3,37,37,423
Langston Galloway,SG,28,DET,26,6,703,100,223,.448,63,147,.429,37,76,.487,.590,47,52,.904,9,45,54,38,14,8,19,31,310
Darius Garland,PG,20,CLE,26,26,726,106,280,.379,44,120,.367,62,160,.388,.457,23,27,.852,11,39,50,76,16,0,67,34,279
Marc Gasol,C,35,TOR,25,25,727,59,163,.362,31,84,.369,28,79,.354,.457,21,28,.750,22,151,173,89,19,30,33,85,170
Rudy Gay,PF,33,SAS,25,5,585,102,228,.447,21,79,.266,81,149,.544,.493,54,61,.885,31,116,147,49,12,16,43,37,279
Paul George,SF,29,LAC,17,17,520,137,307,.446,68,169,.402,69,138,.500,.557,79,87,.908,8,95,103,66,25,7,62,44,421
Taj Gibson,C,34,NYK,25,19,413,55,110,.500,2,10,.200,53,100,.530,.509,9,15,.600,44,67,111,30,17,9,18,55,121
Harry Giles,PF,21,SAC,7,0,52,11,25,.440,0,0,0,11,25,.440,.440,2,2,1.000,3,4,7,5,2,3,5,13,24
Shai Gilgeous-Alexander,SG,21,OKC,25,25,875,167,385,.434,34,97,.351,133,288,.462,.478,94,118,.797,16,111,127,76,24,11,54,49,462
Rudy Gobert,C,27,UTA,24,24,817,135,198,.682,0,0,0,135,198,.682,.682,82,133,.617,84,245,329,35,19,43,52,75,352
Brandon Goodwin,PG,24,ATL,2,0,5,0,1,.000,0,1,.000,0,0,0,.000,0,0,0,0,0,0,0,0,0,2,1,0
Aaron Gordon,PF,24,ORL,23,23,723,117,275,.425,29,93,.312,88,182,.484,.478,54,76,.711,40,120,160,67,16,11,34,49,317
Eric Gordon,SG,31,HOU,9,2,265,34,110,.309,21,74,.284,13,36,.361,.405,9,14,.643,3,14,17,7,5,2,12,21,98
Devonte' Graham,PG,24,CHO,29,19,988,181,451,.401,108,263,.411,73,188,.388,.521,98,122,.803,29,82,111,216,24,8,90,53,568
Treveon Graham,SG,26,MIN,24,17,497,47,139,.338,13,64,.203,34,75,.453,.385,19,24,.792,23,54,77,24,14,2,14,50,126
Jerami Grant,PF,25,DEN,25,2,573,90,195,.462,33,86,.384,57,109,.523,.546,33,54,.611,13,72,85,25,13,16,21,48,246
Josh Gray,PG,26,NOP,2,0,23,1,2,.500,0,0,0,1,2,.500,.500,0,0,0,1,1,2,2,0,0,5,1,2
Danny Green,SG,32,LAL,27,27,684,79,190,.416,49,135,.363,30,55,.545,.545,17,20,.850,18,86,104,33,34,14,25,61,224
Draymond Green,PF,29,GSW,18,18,516,59,144,.410,13,49,.265,46,95,.484,.455,31,43,.721,7,100,107,104,30,11,41,46,162
JaMychal Green,PF,29,LAC,22,0,469,55,133,.414,34,90,.378,21,43,.488,.541,18,21,.857,29,116,145,10,13,7,20,54,162
Javonte Green,SF,26,BOS,18,0,120,21,35,.600,3,10,.300,18,25,.720,.643,2,5,.400,3,14,17,4,4,3,3,12,47
Jeff Green,PF,33,UTA,26,2,490,67,172,.390,33,97,.340,34,75,.453,.485,47,58,.810,10,58,68,16,10,10,27,45,214
Blake Griffin,PF,30,DET,14,14,397,72,196,.367,23,84,.274,49,112,.438,.426,63,81,.778,13,51,64,46,5,4,34,19,230
Marko Guduric,SG,24,MEM,26,0,382,47,126,.373,18,64,.281,29,62,.468,.444,15,17,.882,12,41,53,36,9,6,28,25,127
Rui Hachimura,PF,21,WAS,24,24,712,143,299,.478,10,47,.213,133,252,.528,.495,45,53,.849,38,105,143,40,18,3,19,57,341
Devon Hall,SG,24,OKC,5,0,20,1,5,.200,0,2,.000,1,3,.333,.200,3,4,.750,0,1,1,3,0,0,1,1,5
Tim Hardaway,SG,27,DAL,25,12,637,115,266,.432,62,166,.373,53,100,.530,.549,41,50,.820,7,52,59,44,14,3,17,46,333
James Harden,SG,30,HOU,26,26,984,291,650,.448,131,363,.361,160,287,.557,.548,308,349,.883,26,127,153,194,51,18,130,87,1021
Maurice Harkless,SF,26,LAC,28,18,666,65,135,.481,16,47,.340,49,88,.557,.541,18,32,.563,28,78,106,30,31,19,28,81,164
Jared Harper,PG,22,PHO,1,0,2,0,1,.000,0,1,.000,0,0,0,.000,0,0,0,0,0,0,0,0,0,0,0,0
Montrezl Harrell,C,26,LAC,28,2,826,217,377,.576,0,11,.000,217,366,.593,.576,101,155,.652,81,132,213,55,21,35,49,68,535
Gary Harris,SG,25,DEN,25,25,813,104,249,.418,39,108,.361,65,141,.461,.496,30,38,.789,14,59,73,54,27,7,25,54,277
Joe Harris,SF,28,BRK,26,26,813,143,297,.481,70,163,.429,73,134,.545,.599,22,27,.815,22,76,98,55,17,8,37,66,378
Tobias Harris,PF,27,PHI,28,28,959,219,447,.490,38,120,.317,181,327,.554,.532,76,95,.800,20,174,194,91,24,24,55,70,552
Shaquille Harrison,SF,26,CHI,17,4,141,20,49,.408,3,10,.300,17,39,.436,.439,11,18,.611,6,24,30,22,8,4,6,16,54
Josh Hart,SF,24,NOP,20,4,551,77,182,.423,46,126,.365,31,56,.554,.549,30,38,.789,19,99,118,30,22,7,26,58,230
Isaiah Hartenstein,C,21,HOU,9,0,103,11,16,.688,0,1,.000,11,15,.733,.688,9,11,.818,8,18,26,5,3,4,6,17,31
Udonis Haslem,PF,39,MIA,2,0,11,1,1,1.000,0,0,0,1,1,1.000,1.000,3,4,.750,0,3,3,0,0,0,0,3,5
Jaxson Hayes,C,19,NOP,24,10,513,83,132,.629,0,3,.000,83,129,.643,.629,53,81,.654,45,68,113,19,19,25,21,74,219
Gordon Hayward,SF,29,BOS,11,11,337,80,144,.556,15,38,.395,65,106,.613,.608,18,23,.783,8,59,67,45,8,3,20,20,193
John Henson,PF,29,CLE,8,0,99,18,29,.621,2,7,.286,16,22,.727,.655,3,11,.273,7,14,21,9,6,8,8,13,41
Dewan Hernandez,C,23,TOR,3,0,9,1,5,.200,0,1,.000,1,4,.250,.200,2,2,1.000,2,5,7,0,1,0,1,5,4
Juan Hernangómez,PF,24,DEN,16,0,222,24,63,.381,12,39,.308,12,24,.500,.476,7,13,.538,10,30,40,11,1,3,10,15,67
Willy Hernangómez,C,25,CHO,9,0,64,10,24,.417,2,6,.333,8,18,.444,.458,4,8,.500,9,13,22,3,1,3,5,4,26
Tyler Herro,SG,20,MIA,25,3,722,124,293,.423,51,136,.375,73,157,.465,.510,47,55,.855,7,91,98,48,18,3,47,32,346
Mario Hezonja,PF,24,POR,23,4,398,35,98,.357,10,31,.323,25,67,.373,.408,22,27,.815,16,88,104,22,13,2,20,51,102
Buddy Hield,SG,27,SAC,26,26,895,210,481,.437,102,271,.376,108,210,.514,.543,47,55,.855,26,107,133,75,22,9,67,68,569
George Hill,PG,33,MIL,25,0,535,83,153,.542,39,73,.534,44,80,.550,.670,35,42,.833,27,51,78,78,21,2,21,40,240
Solomon Hill,SF,28,MEM,24,1,484,55,132,.417,30,76,.395,25,56,.446,.530,11,18,.611,14,64,78,47,25,2,22,38,151
Jaylen Hoard,SF,20,POR,5,0,18,3,6,.500,0,0,0,3,6,.500,.500,1,2,.500,3,4,7,2,1,0,0,1,7
Aaron Holiday,PG,23,IND,25,9,532,92,217,.424,37,94,.394,55,123,.447,.509,24,28,.857,10,56,66,64,21,2,32,39,245
Jrue Holiday,SG,29,NOP,25,25,901,197,434,.454,45,133,.338,152,301,.505,.506,47,70,.671,33,93,126,170,44,19,85,59,486
Justin Holiday,SG,30,IND,27,2,678,75,181,.414,42,110,.382,33,71,.465,.530,19,23,.826,13,90,103,40,30,16,16,46,211
Rondae Hollis-Jefferson,SF,25,TOR,18,0,351,58,112,.518,1,7,.143,57,105,.543,.522,30,41,.732,43,52,95,25,13,6,22,32,147
Richaun Holmes,C,26,SAC,26,22,750,131,196,.668,0,0,0,131,196,.668,.668,49,62,.790,68,147,215,25,28,34,31,106,311
Rodney Hood,SF,27,POR,21,21,619,87,172,.506,35,71,.493,52,101,.515,.608,21,27,.778,10,62,72,32,17,4,19,46,230
Al Horford,C,33,PHI,24,24,735,134,284,.472,34,99,.343,100,185,.541,.532,25,37,.676,42,124,166,94,27,26,29,57,327
Talen Horton-Tucker,SG,19,LAL,1,0,2,0,1,.000,0,1,.000,0,0,0,.000,0,0,0,0,0,0,1,0,0,0,0,0
Danuel House,SF,26,HOU,20,18,601,73,165,.442,44,109,.404,29,56,.518,.576,32,40,.800,24,60,84,26,21,12,20,43,222
Dwight Howard,C,34,LAL,27,0,539,70,97,.722,1,3,.333,69,94,.734,.727,35,69,.507,58,132,190,20,11,37,31,97,176
Kevin Huerter,SG,21,ATL,16,8,368,45,114,.395,25,70,.357,20,44,.455,.504,15,19,.789,8,44,52,52,12,7,25,30,130
De'Andre Hunter,SF,22,ATL,26,25,830,116,291,.399,46,130,.354,70,161,.435,.478,51,66,.773,14,91,105,49,17,8,44,68,329
Chandler Hutchison,SF,23,CHI,9,6,154,20,44,.455,5,12,.417,15,32,.469,.511,19,29,.655,1,32,33,8,5,2,12,12,64
Serge Ibaka,C,30,TOR,15,0,330,69,157,.439,12,36,.333,57,121,.471,.478,33,39,.846,29,79,108,19,8,15,30,38,183
Ersan İlyasova,PF,32,MIL,24,1,391,69,134,.515,20,60,.333,49,74,.662,.590,31,37,.838,31,85,116,18,11,7,7,41,189
Joe Ingles,SF,32,UTA,26,6,737,74,187,.396,39,117,.333,35,70,.500,.500,28,36,.778,7,99,106,110,26,2,46,63,215
Brandon Ingram,PF,22,NOP,23,23,767,207,417,.496,53,130,.408,154,287,.537,.560,109,130,.838,19,142,161,86,17,18,66,75,576
Kyrie Irving,PG,27,BRK,11,11,372,112,252,.444,31,91,.341,81,161,.503,.506,59,63,.937,10,49,59,79,12,6,26,32,314
Jonathan Isaac,SF,22,ORL,24,24,742,118,257,.459,27,80,.338,91,177,.514,.512,46,56,.821,40,135,175,34,30,64,37,57,309
Wesley Iwundu,SF,25,ORL,13,3,182,14,44,.318,1,12,.083,13,32,.406,.330,15,18,.833,5,22,27,11,7,3,6,10,44
Frank Jackson,PG,21,NOP,23,1,330,53,142,.373,20,66,.303,33,76,.434,.444,26,32,.813,5,25,30,22,9,1,22,34,152
Jaren Jackson,C,20,MEM,25,25,681,159,335,.475,60,150,.400,99,185,.535,.564,61,79,.772,27,93,120,37,13,31,48,106,439
Justin Jackson,PF,24,DAL,24,0,343,56,125,.448,23,61,.377,33,64,.516,.540,10,13,.769,10,50,60,10,5,2,4,29,145
Reggie Jackson,PG,29,DET,2,2,36,4,11,.364,1,5,.200,3,6,.500,.409,1,1,1.000,1,4,5,8,0,0,1,2,10
Justin James,SG,23,SAC,12,0,143,18,44,.409,3,14,.214,15,30,.500,.443,1,6,.167,2,18,20,9,4,6,5,12,40
LeBron James,PG,35,LAL,27,27,937,273,544,.502,61,167,.365,212,377,.562,.558,99,145,.683,28,169,197,288,35,16,107,47,706
Amile Jefferson,PF,26,ORL,6,0,17,3,4,.750,0,0,0,3,4,.750,.750,0,2,.000,3,2,5,2,0,0,1,3,6
DaQuan Jeffries,SG,22,SAC,2,0,11,1,1,1.000,0,0,0,1,1,1.000,1.000,0,0,0,1,0,1,1,0,0,0,1,2
Ty Jerome,PG,22,PHO,6,0,77,6,24,.250,3,9,.333,3,15,.200,.313,2,2,1.000,0,10,10,13,9,0,6,10,17
Alize Johnson,SF,23,IND,9,0,39,5,11,.455,0,0,0,5,11,.455,.455,3,4,.750,6,7,13,2,0,0,1,6,13
B.J. Johnson,SF,24,ORL,1,0,3,0,0,0,0,0,0,0,0,0,0,0,0,0,0,0,0,0,0,0,0,0,0
Cameron Johnson,PF,23,PHO,23,0,477,73,168,.435,46,113,.407,27,55,.491,.571,20,23,.870,23,50,73,21,13,7,17,39,212
James Johnson,PF,32,MIA,6,0,68,8,18,.444,2,9,.222,6,9,.667,.500,2,4,.500,2,9,11,4,3,2,4,5,20
Keldon Johnson,SF,20,SAS,1,0,2,0,1,.000,0,0,0,0,1,.000,.000,0,0,0,0,0,0,0,0,0,0,0,0
Stanley Johnson,PF,23,TOR,5,0,19,3,9,.333,1,4,.250,2,5,.400,.389,0,0,0,2,5,7,0,1,0,4,6,7
Tyler Johnson,SG,27,PHO,20,3,380,44,116,.379,18,58,.310,26,58,.448,.457,20,26,.769,5,31,36,42,7,7,19,30,126
Nikola Jokić,C,24,DEN,25,25,785,173,360,.481,27,103,.262,146,257,.568,.518,53,68,.779,53,201,254,162,25,14,62,75,426
Damian Jones,C,24,ATL,26,18,485,81,113,.717,2,5,.400,79,108,.731,.726,35,51,.686,40,63,103,19,11,24,17,90,199
Derrick Jones,SF,22,MIA,12,0,223,27,55,.491,5,18,.278,22,37,.595,.536,17,24,.708,6,29,35,14,13,4,8,28,76
Tyus Jones,PG,23,MEM,26,6,529,66,164,.402,10,41,.244,56,123,.455,.433,19,26,.731,1,39,40,130,24,3,32,24,161
DeAndre Jordan,C,31,BRK,23,3,492,79,119,.664,0,0,0,79,119,.664,.664,34,51,.667,62,160,222,46,9,23,24,48,192
Cory Joseph,PG,28,SAC,26,17,691,62,169,.367,15,52,.288,47,117,.402,.411,18,18,1.000,12,56,68,100,21,13,34,52,157
Mfiondu Kabengele,C,22,LAC,9,0,38,8,19,.421,5,11,.455,3,8,.375,.553,3,3,1.000,1,6,7,1,1,1,1,4,24
Frank Kaminsky,C,26,PHO,25,12,599,104,230,.452,32,94,.340,72,136,.529,.522,47,73,.644,25,108,133,57,10,10,25,55,287
Enes Kanter,C,27,BOS,17,3,277,55,91,.604,0,2,.000,55,89,.618,.604,24,37,.649,43,59,102,18,11,10,12,26,134
Luke Kennard,SG,23,DET,25,22,822,137,312,.439,65,163,.399,72,149,.483,.543,66,73,.904,6,80,86,103,12,6,35,58,405
Stanton Kidd,SF,27,UTA,4,0,15,0,3,.000,0,1,.000,0,2,.000,.000,0,0,0,0,3,3,1,0,0,2,3,0
Michael Kidd-Gilchrist,PF,26,CHO,7,0,114,12,42,.286,3,14,.214,9,28,.321,.321,5,7,.714,8,21,29,7,0,2,6,14,32
Maxi Kleber,C,28,DAL,24,5,582,68,153,.444,34,89,.382,34,64,.531,.556,29,32,.906,39,90,129,25,6,16,16,46,199
Brandon Knight,PG,28,CLE,9,0,102,15,43,.349,11,33,.333,4,10,.400,.477,3,8,.375,1,7,8,16,4,0,7,9,44
Kevin Knox,SF,20,NYK,26,3,514,64,173,.370,30,92,.326,34,81,.420,.457,32,49,.653,12,63,75,32,12,11,18,41,190
John Konchar,SG,23,MEM,1,0,7,0,0,0,0,0,0,0,0,0,0,0,0,0,0,0,0,0,0,0,0,0,0
Furkan Korkmaz,SG,22,PHI,27,11,580,79,185,.427,41,115,.357,38,70,.543,.538,17,21,.810,4,57,61,24,10,6,19,41,216
Luke Kornet,C,24,CHI,14,0,142,15,48,.313,5,27,.185,10,21,.476,.365,5,5,1.000,6,16,22,6,2,10,3,13,40
Kyle Korver,SF,38,MIL,22,0,338,39,106,.368,32,89,.360,7,17,.412,.519,9,11,.818,6,30,36,17,10,4,19,23,119
Rodions Kurucs,PF,21,BRK,12,0,122,10,28,.357,4,9,.444,6,19,.316,.429,3,8,.375,7,25,32,4,6,1,15,20,27
Kyle Kuzma,PF,24,LAL,20,1,461,81,187,.433,32,89,.360,49,98,.500,.519,27,39,.692,8,60,68,17,6,8,35,34,221
Skal Labissière,C,23,POR,26,0,442,62,113,.549,2,9,.222,60,104,.577,.558,15,22,.682,52,80,132,30,6,24,24,68,141
Jeremy Lamb,SG,27,IND,18,18,560,100,218,.459,21,70,.300,79,148,.534,.507,41,50,.820,11,78,89,46,20,11,25,38,262
Romeo Langford,SG,20,BOS,1,0,0,0,0,0,0,0,0,0,0,0,0,0,0,0,0,0,0,0,0,0,0,0,0
Zach LaVine,SG,24,CHI,28,28,916,216,501,.431,86,209,.411,130,292,.445,.517,116,143,.811,22,104,126,108,35,13,93,66,634
Jake Layman,PF,25,MIN,14,2,369,61,132,.462,19,54,.352,42,78,.538,.534,6,10,.600,12,29,41,11,12,10,18,31,147
T.J. Leaf,PF,22,IND,17,1,163,26,58,.448,5,11,.455,21,47,.447,.491,5,8,.625,20,38,58,6,7,3,6,15,62
Courtney Lee,SG,34,DAL,7,3,62,13,22,.591,7,12,.583,6,10,.600,.750,0,0,0,0,3,3,3,0,2,1,5,33
Damion Lee,SG,27,GSW,14,1,316,51,124,.411,15,48,.313,36,76,.474,.472,33,40,.825,11,41,52,25,9,0,15,21,150
Alex Len,C,26,ATL,26,9,458,85,160,.531,8,33,.242,77,127,.606,.556,35,51,.686,42,89,131,29,14,20,22,55,213
Kawhi Leonard,SF,28,LAC,20,20,630,179,398,.450,35,98,.357,144,300,.480,.494,123,140,.879,22,136,158,102,36,14,72,41,516
Meyers Leonard,PF,27,MIA,26,26,466,61,105,.581,24,49,.490,37,56,.661,.695,5,9,.556,8,98,106,25,7,11,19,53,151
Caris LeVert,SG,25,BRK,9,9,284,59,140,.421,13,36,.361,46,104,.442,.468,20,31,.645,10,35,45,36,6,1,31,20,151
Damian Lillard,PG,29,POR,24,24,879,196,442,.443,79,218,.362,117,224,.522,.533,160,176,.909,12,94,106,180,24,10,68,47,631
Nassir Little,PF,19,POR,18,3,270,31,76,.408,5,30,.167,26,46,.565,.441,15,22,.682,20,42,62,12,8,7,9,35,82
Kevon Looney,C,23,GSW,8,3,91,9,28,.321,1,2,.500,8,26,.308,.339,3,5,.600,12,12,24,3,3,2,6,14,22
Brook Lopez,C,31,MIL,25,25,655,83,212,.392,36,120,.300,47,92,.511,.476,45,50,.900,15,110,125,37,16,58,25,60,247
Robin Lopez,C,31,MIL,27,2,391,59,120,.492,14,47,.298,45,73,.616,.550,14,22,.636,29,50,79,18,5,18,33,44,146
Kevin Love,PF,31,CLE,22,22,670,114,260,.438,46,126,.365,68,134,.507,.527,82,96,.854,24,213,237,58,14,8,60,30,356
Kyle Lowry,PG,33,TOR,14,14,522,77,190,.405,39,115,.339,38,75,.507,.508,72,80,.900,8,58,66,95,18,5,42,39,265
Timothé Luwawu-Cabarrot,SG,24,BRK,4,0,46,6,14,.429,1,6,.167,5,8,.625,.464,3,4,.750,0,6,6,1,1,0,4,2,16
Trey Lyles,PF,24,SAS,25,15,419,41,95,.432,19,53,.358,22,42,.524,.532,5,9,.556,32,117,149,31,7,8,20,29,106
Daryl Macon,SG,24,MIA,4,0,14,1,3,.333,1,2,.500,0,1,.000,.500,0,0,0,0,0,0,1,0,0,2,1,3
Josh Magette,PG,30,ORL,3,0,10,2,6,.333,0,0,0,2,6,.333,.333,1,2,.500,1,2,3,2,2,0,3,0,5
Ian Mahinmi,C,33,WAS,4,1,68,10,19,.526,0,2,.000,10,17,.588,.526,9,12,.750,8,9,17,3,1,6,5,11,29
Thon Maker,C,22,DET,24,1,257,25,48,.521,7,14,.500,18,34,.529,.594,18,33,.545,13,30,43,10,6,16,12,34,75
Terance Mann,SG,23,LAC,22,5,203,21,42,.500,2,9,.222,19,33,.576,.524,8,10,.800,3,22,25,28,6,3,12,26,52
Boban Marjanović,C,31,DAL,10,1,131,31,56,.554,0,1,.000,31,55,.564,.554,13,16,.813,15,40,55,7,2,3,9,18,75
Lauri Markkanen,PF,22,CHI,28,28,843,128,325,.394,56,169,.331,72,156,.462,.480,88,108,.815,30,164,194,49,24,14,53,59,400
Caleb Martin,SF,24,CHO,5,0,32,3,10,.300,0,3,.000,3,7,.429,.300,3,5,.600,1,4,5,3,1,2,3,3,9
Cody Martin,SF,24,CHO,20,0,260,21,56,.375,4,24,.167,17,32,.531,.411,20,29,.690,10,38,48,23,15,3,12,25,66
Kelan Martin,SF,24,MIN,9,0,123,15,44,.341,5,24,.208,10,20,.500,.398,0,0,0,2,24,26,3,1,1,4,20,35
Frank Mason,PG,25,MIL,3,0,13,1,4,.250,1,2,.500,0,2,.000,.375,1,2,.500,0,1,1,4,1,0,1,2,4
Garrison Mathews,SG,23,WAS,3,0,19,1,3,.333,1,3,.333,0,0,0,.500,0,0,0,0,2,2,2,0,0,2,3,3
Wesley Matthews,SG,33,MIL,27,27,641,72,166,.434,43,114,.377,29,52,.558,.563,23,27,.852,5,59,64,37,17,2,19,37,210
Patrick McCaw,SF,24,TOR,4,0,78,4,14,.286,1,8,.125,3,6,.500,.321,1,2,.500,3,5,8,6,3,0,5,5,10
CJ McCollum,SG,28,POR,26,26,942,223,499,.447,67,178,.376,156,321,.486,.514,43,54,.796,20,93,113,95,19,22,51,73,556
T.J. McConnell,PG,27,IND,25,0,441,76,154,.494,1,5,.200,75,149,.503,.497,12,13,.923,10,55,65,124,14,5,34,29,165
Jalen McDaniels,PF,22,CHO,2,0,7,2,5,.400,0,1,.000,2,4,.500,.400,0,0,0,1,0,1,0,0,0,0,0,4
Doug McDermott,PF,28,IND,27,0,567,96,205,.468,49,103,.476,47,102,.461,.588,16,20,.800,13,65,78,31,3,3,21,54,257
JaVale McGee,C,32,LAL,27,27,442,86,136,.632,0,0,0,86,136,.632,.632,21,33,.636,53,113,166,17,16,34,23,62,193
Rodney McGruder,SG,28,LAC,17,2,300,24,67,.358,11,39,.282,13,28,.464,.440,5,10,.500,12,31,43,14,6,4,7,31,64
Alfonzo McKinnie,SF,27,CLE,18,0,181,17,52,.327,8,25,.320,9,27,.333,.404,7,11,.636,11,26,37,3,6,3,8,21,49
Jordan McLaughlin,PG,23,MIN,4,0,57,4,15,.267,1,8,.125,3,7,.429,.300,2,2,1.000,1,6,7,8,1,0,4,4,11
Ben McLemore,SG,26,HOU,26,8,608,88,211,.417,65,179,.363,23,32,.719,.571,29,35,.829,9,51,60,27,18,7,21,53,270
Jordan McRae,SG,28,WAS,13,0,235,43,91,.473,13,33,.394,30,58,.517,.544,17,19,.895,3,28,31,36,8,4,14,26,116
Nicolò Melli,C,29,NOP,23,3,348,41,102,.402,22,70,.314,19,32,.594,.510,19,24,.792,14,46,60,25,14,4,18,42,123
De'Anthony Melton,PG,21,MEM,15,0,236,31,76,.408,6,21,.286,25,55,.455,.447,19,22,.864,11,40,51,46,18,4,22,31,87
Chimezie Metu,PF,22,SAS,6,0,21,7,12,.583,0,0,0,7,12,.583,.583,2,4,.500,7,4,11,2,0,2,0,0,16
Khris Middleton,SF,28,MIL,20,17,553,139,278,.500,43,104,.413,96,174,.552,.577,51,57,.895,14,94,108,70,18,2,38,46,372
C.J. Miles,SG,32,WAS,10,0,161,19,59,.322,11,35,.314,8,24,.333,.415,15,20,.750,4,8,12,12,10,4,4,14,64
Malcolm Miller,SF,26,TOR,11,1,58,6,12,.500,5,10,.500,1,2,.500,.708,1,6,.167,0,7,7,4,0,2,2,6,18
Patty Mills,PG,31,SAS,25,1,598,103,226,.456,55,131,.420,48,95,.505,.577,31,39,.795,5,33,38,56,23,5,26,40,292
Paul Millsap,PF,34,DEN,23,23,582,100,210,.476,25,55,.455,75,155,.484,.536,65,74,.878,45,89,134,28,20,19,29,61,290
Shake Milton,SG,23,PHI,9,0,82,12,35,.343,4,19,.211,8,16,.500,.400,7,9,.778,1,7,8,7,1,0,12,13,35
Donovan Mitchell,SG,23,UTA,26,26,902,240,535,.449,59,163,.362,181,372,.487,.504,111,133,.835,23,100,123,95,31,8,62,59,650
Naz Mitrou-Long,SG,26,IND,3,0,43,6,16,.375,2,11,.182,4,5,.800,.438,0,0,0,0,6,6,7,1,1,2,1,14
Malik Monk,SG,21,CHO,28,0,566,97,224,.433,27,105,.257,70,119,.588,.493,34,40,.850,8,65,73,61,11,6,39,44,255
E'Twaun Moore,SG,30,NOP,16,3,326,59,140,.421,21,55,.382,38,85,.447,.496,14,22,.636,13,38,51,23,8,1,11,27,153
Ja Morant,PG,20,MEM,20,20,579,135,292,.462,20,47,.426,115,245,.469,.497,84,105,.800,16,48,64,127,27,6,65,32,374
Juwan Morgan,PF,22,UTA,3,0,9,0,0,0,0,0,0,0,0,0,0,0,0,0,0,2,2,0,0,0,1,1,0
Marcus Morris,SF,30,NYK,25,25,813,153,358,.427,70,148,.473,83,210,.395,.525,92,108,.852,29,116,145,35,23,13,45,79,468
Markieff Morris,PF,30,DET,25,12,552,98,207,.473,41,99,.414,57,108,.528,.572,27,37,.730,15,85,100,38,16,5,44,56,264
Monte Morris,PG,24,DEN,25,0,450,70,163,.429,13,35,.371,57,128,.445,.469,25,33,.758,5,36,41,84,13,7,19,20,178
Johnathan Motley,PF,24,LAC,3,0,7,1,3,.333,1,1,1.000,0,2,.000,.500,0,0,0,1,1,2,2,1,0,3,1,3
Emmanuel Mudiay,PG,23,UTA,23,0,371,63,136,.463,11,34,.324,52,102,.510,.504,29,37,.784,7,52,59,55,6,6,39,40,166
Dejounte Murray,PG,23,SAS,22,14,499,86,186,.462,5,26,.192,81,160,.506,.476,41,53,.774,25,109,134,90,37,7,49,51,218
Jamal Murray,PG,22,DEN,25,25,787,160,373,.429,41,124,.331,119,249,.478,.484,61,69,.884,20,89,109,114,34,8,54,43,422
Džanan Musa,SF,20,BRK,21,0,301,30,97,.309,9,49,.184,21,48,.438,.356,23,31,.742,10,41,51,24,9,1,24,17,92
Mike Muscala,C,28,OKC,16,0,177,19,61,.311,12,46,.261,7,15,.467,.410,7,8,.875,6,30,36,14,4,3,6,21,57
Sviatoslav Mykhailiuk,SF,22,DET,21,1,342,37,89,.416,29,66,.439,8,23,.348,.579,5,6,.833,4,20,24,26,8,1,17,24,108
Abdel Nader,SF,26,OKC,18,5,322,48,95,.505,22,47,.468,26,48,.542,.621,23,27,.852,6,29,35,11,7,6,19,28,141
Larry Nance,C,27,CLE,24,4,608,83,166,.500,27,74,.365,56,92,.609,.581,25,35,.714,44,134,178,36,20,11,23,39,218
Shabazz Napier,PG,28,MIN,13,0,226,27,75,.360,11,48,.229,16,27,.593,.433,21,24,.875,1,23,24,40,14,3,22,15,86
Raul Neto,PG,27,PHI,25,2,312,43,87,.494,16,33,.485,27,54,.500,.586,4,6,.667,3,26,29,40,12,2,24,18,106
Georges Niang,PF,26,UTA,20,0,240,32,67,.478,18,43,.419,14,24,.583,.612,7,10,.700,2,34,36,10,2,3,10,28,89
Nerlens Noel,C,25,OKC,24,3,445,71,109,.651,0,0,0,71,109,.651,.651,39,48,.813,33,85,118,34,24,36,25,68,181
Zach Norvell,SG,22,LAL,2,0,5,0,1,.000,0,0,0,0,1,.000,.000,0,0,0,0,1,1,0,0,0,0,0,0
Jaylen Nowell,SG,20,MIN,2,0,15,1,4,.250,0,3,.000,1,1,1.000,.250,1,1,1.000,0,1,1,3,0,0,1,1,3
Frank Ntilikina,PG,21,NYK,25,21,614,58,152,.382,21,64,.328,37,88,.420,.451,16,20,.800,9,42,51,77,34,10,29,64,153
Kendrick Nunn,SG,24,MIA,26,26,805,166,370,.449,55,157,.350,111,213,.521,.523,31,38,.816,7,65,72,93,28,7,54,69,418
David Nwaba,SF,27,BRK,18,0,234,32,62,.516,10,23,.435,22,39,.564,.597,14,22,.636,8,32,40,6,9,10,8,27,88
Royce O'Neale,PF,26,UTA,26,24,744,57,123,.463,33,74,.446,24,49,.490,.598,12,14,.857,5,115,120,68,21,6,21,77,159
Kyle O'Quinn,C,29,PHI,17,0,169,24,48,.500,6,16,.375,18,32,.563,.563,3,8,.375,19,42,61,23,2,13,16,24,57
Semi Ojeleye,PF,25,BOS,24,1,373,22,55,.400,12,35,.343,10,20,.500,.509,7,10,.700,8,41,49,11,10,2,5,30,63
Jahlil Okafor,C,24,NOP,17,8,309,60,98,.612,1,2,.500,59,96,.615,.617,28,42,.667,29,49,78,29,5,15,26,50,149
Elie Okobo,PG,22,PHO,17,0,167,23,58,.397,10,26,.385,13,32,.406,.483,14,25,.560,2,14,16,39,4,0,4,10,70
Josh Okogie,SG,21,MIN,23,8,586,64,149,.430,19,60,.317,45,89,.506,.493,61,77,.792,32,83,115,36,23,8,35,54,208
KZ Okpala,SF,20,MIA,3,0,3,0,0,0,0,0,0,0,0,0,0,0,0,0,0,1,1,0,0,0,1,0,0
Kelly Olynyk,C,28,MIA,26,0,603,79,170,.465,42,100,.420,37,70,.529,.588,41,46,.891,25,106,131,36,23,9,34,71,241
Miye Oni,SG,22,UTA,3,0,8,0,0,0,0,0,0,0,0,0,0,0,0,0,0,1,1,0,0,0,1,0,0
Cedi Osman,SF,24,CLE,26,26,752,88,214,.411,41,114,.360,47,100,.470,.507,21,32,.656,9,77,86,57,27,8,33,58,238
Kelly Oubre,SF,24,PHO,25,25,819,151,344,.439,38,118,.322,113,226,.500,.494,94,118,.797,34,124,158,34,33,21,39,83,434
Jabari Parker,PF,24,ATL,27,22,749,177,350,.506,29,101,.287,148,249,.594,.547,48,67,.716,46,125,171,47,38,15,52,85,431
Chandler Parsons,SF,31,ATL,4,0,43,5,14,.357,4,12,.333,1,2,.500,.500,0,0,0,1,5,6,2,4,0,2,3,14
Eric Paschall,PF,23,GSW,25,19,772,149,302,.493,17,59,.288,132,243,.543,.522,88,109,.807,35,91,126,42,9,9,40,49,403
Patrick Patterson,PF,30,LAC,25,12,372,42,107,.393,33,82,.402,9,25,.360,.547,17,24,.708,18,61,79,20,4,2,8,19,134
Justin Patton,C,22,OKC,2,0,9,1,3,.333,0,1,.000,1,2,.500,.333,0,0,0,0,2,2,0,0,0,1,4,2
Chris Paul,PG,34,OKC,25,25,781,129,284,.454,37,105,.352,92,179,.514,.519,96,108,.889,6,100,106,157,42,5,43,59,391
Elfrid Payton,PG,25,NYK,10,3,225,36,85,.424,7,19,.368,29,66,.439,.465,8,10,.800,12,22,34,48,17,1,17,16,87
Norvel Pelle,SF,26,PHI,4,0,57,6,8,.750,0,0,0,6,8,.750,.750,4,6,.667,4,15,19,4,0,9,6,12,16
Theo Pinson,SG,24,BRK,17,0,253,32,108,.296,11,52,.212,21,56,.375,.347,13,14,.929,8,32,40,36,9,2,27,23,88
Mason Plumlee,C,29,DEN,25,0,429,69,119,.580,0,4,.000,69,115,.600,.580,29,57,.509,45,97,142,61,17,21,38,60,167
Vincent Poirier,C,26,BOS,9,0,44,7,14,.500,0,0,0,7,14,.500,.500,1,2,.500,8,7,15,3,2,2,3,10,15
Jakob Pöltl,C,24,SAS,25,7,474,63,106,.594,0,0,0,63,106,.594,.594,22,38,.579,57,96,153,38,16,34,21,42,148
Shamorie Ponds,PG,21,TOR,3,0,9,2,4,.500,0,1,.000,2,3,.667,.500,0,0,0,0,1,1,2,0,1,0,2,4
Jordan Poole,SG,20,GSW,26,9,602,61,239,.255,31,127,.244,30,112,.268,.320,45,54,.833,4,50,54,53,17,6,30,46,198
Kevin Porter,SF,19,CLE,25,1,530,74,173,.428,21,66,.318,53,107,.495,.488,28,38,.737,8,67,75,49,24,5,39,60,197
Michael Porter,PF,21,DEN,16,0,142,29,66,.439,7,21,.333,22,45,.489,.492,8,11,.727,16,28,44,7,0,5,12,17,73
Otto Porter,SF,26,CHI,9,9,226,35,84,.417,16,40,.400,19,44,.432,.512,15,20,.750,8,23,31,14,9,3,7,20,101
Bobby Portis,C,24,NYK,27,2,578,96,230,.417,26,74,.351,70,156,.449,.474,25,34,.735,40,113,153,31,16,9,28,45,243
Kristaps Porziņģis,PF,24,DAL,24,24,734,144,363,.397,47,144,.326,97,219,.443,.461,68,95,.716,41,173,214,33,13,49,36,72,403
Dwight Powell,C,28,DAL,22,19,564,73,108,.676,7,16,.438,66,92,.717,.708,27,48,.563,35,72,107,28,18,9,19,54,180
Norman Powell,SG,26,TOR,25,14,711,127,262,.485,46,121,.380,81,141,.574,.573,53,65,.815,14,82,96,38,26,10,41,50,353
Julius Randle,PF,25,NYK,27,27,868,171,384,.445,27,102,.265,144,282,.511,.480,101,151,.669,63,173,236,93,19,3,83,75,470
Cam Reddish,SF,20,ATL,24,17,608,70,216,.324,26,98,.265,44,118,.373,.384,37,51,.725,17,78,95,37,21,10,46,46,203
J.J. Redick,SG,35,NOP,26,22,755,131,294,.446,86,188,.457,45,106,.425,.592,70,80,.875,5,73,78,55,11,6,32,43,418
Naz Reid,C,20,MIN,2,0,4,1,2,.500,1,2,.500,0,0,0,.750,0,0,0,0,1,1,0,0,0,0,1,3
Josh Richardson,SG,26,PHI,20,20,607,108,248,.435,35,94,.372,73,154,.474,.506,43,56,.768,15,52,67,60,22,12,42,56,294
Austin Rivers,SG,27,HOU,24,1,591,73,179,.408,32,100,.320,41,79,.519,.497,21,30,.700,17,48,65,41,11,7,15,48,199
Duncan Robinson,SF,25,MIA,26,21,714,103,219,.470,81,184,.440,22,35,.629,.655,15,16,.938,3,77,80,22,19,9,16,69,302
Glenn Robinson,SF,26,GSW,28,28,893,129,283,.456,33,89,.371,96,194,.495,.514,30,36,.833,42,91,133,46,27,7,24,47,321
Jerome Robinson,SG,22,LAC,23,0,292,32,96,.333,12,45,.267,20,51,.392,.396,6,11,.545,3,35,38,25,7,7,17,34,82
Justin Robinson,PG,22,WAS,6,0,20,3,6,.500,1,1,1.000,2,5,.400,.583,0,0,0,1,2,3,3,0,0,2,0,7
Mitchell Robinson,C,21,NYK,23,6,510,89,130,.685,0,0,0,89,130,.685,.685,42,68,.618,72,85,157,13,16,42,18,77,220
Rajon Rondo,PG,33,LAL,15,0,324,46,106,.434,20,44,.455,26,62,.419,.528,10,13,.769,5,50,55,86,17,1,28,17,122
Derrick Rose,PG,31,DET,21,1,504,139,287,.484,19,57,.333,120,230,.522,.517,47,54,.870,11,31,42,126,17,7,52,23,344
Terrence Ross,SG,28,ORL,24,0,593,110,266,.414,49,146,.336,61,120,.508,.506,45,53,.849,7,60,67,25,24,8,26,40,314
Terry Rozier,PG,25,CHO,29,29,952,171,413,.414,72,185,.389,99,228,.434,.501,68,80,.850,21,114,135,124,34,4,77,65,482
Ricky Rubio,PG,29,PHO,20,20,644,98,246,.398,23,75,.307,75,171,.439,.445,56,67,.836,13,77,90,187,26,4,41,51,275
D'Angelo Russell,SG,23,GSW,16,16,496,122,287,.425,46,134,.343,76,153,.497,.505,54,73,.740,4,50,54,99,14,5,53,36,344
Domantas Sabonis,C,23,IND,25,25,859,176,345,.510,5,26,.192,171,319,.536,.517,86,110,.782,84,253,337,96,20,13,69,94,443
JaKarr Sampson,SF,26,IND,9,7,166,23,41,.561,2,10,.200,21,31,.677,.585,2,7,.286,7,17,24,4,5,6,6,23,50
Dario Šarić,PF,25,PHO,25,25,712,104,241,.432,40,121,.331,64,120,.533,.515,37,43,.860,44,145,189,56,20,10,33,70,285
Tomáš Satoranský,PG,28,CHI,28,28,762,92,213,.432,30,81,.370,62,132,.470,.502,43,50,.860,23,68,91,148,40,4,58,55,257
Admiral Schofield,SF,22,WAS,11,0,97,12,20,.600,7,14,.500,5,6,.833,.775,5,6,.833,2,11,13,4,1,0,3,11,36
Dennis Schröder,PG,26,OKC,25,0,739,165,358,.461,42,124,.339,123,234,.526,.520,52,64,.813,8,85,93,85,18,8,66,58,424
Mike Scott,PF,31,PHI,28,4,538,67,150,.447,37,99,.374,30,51,.588,.570,12,15,.800,21,75,96,18,9,2,10,40,183
Thabo Sefolosha,PF,35,HOU,21,0,217,16,46,.348,8,28,.286,8,18,.444,.435,0,1,.000,11,36,47,15,9,4,7,20,40
Collin Sexton,SG,21,CLE,26,26,791,174,397,.438,26,88,.295,148,309,.479,.471,78,95,.821,25,52,77,61,25,1,48,52,452
Landry Shamet,SG,22,LAC,11,11,315,34,82,.415,24,62,.387,10,20,.500,.561,10,10,1.000,1,18,19,17,4,1,13,33,102
Iman Shumpert,SG,29,BRK,13,0,241,21,64,.328,8,33,.242,13,31,.419,.391,4,7,.571,9,25,34,12,12,2,10,21,54
Pascal Siakam,PF,25,TOR,25,25,919,230,507,.454,56,152,.368,174,355,.490,.509,102,126,.810,38,170,208,90,25,22,68,70,618
Chris Silva,PF,23,MIA,23,0,223,31,47,.660,0,2,.000,31,45,.689,.660,26,36,.722,41,45,86,13,5,15,25,57,88
Ben Simmons,PG,23,PHI,26,26,892,152,266,.571,2,5,.400,150,261,.575,.575,66,111,.595,38,138,176,213,55,17,95,85,372
Anfernee Simons,SG,20,POR,26,1,566,98,230,.426,38,110,.345,60,120,.500,.509,32,43,.744,7,43,50,40,12,4,24,52,266
Marcus Smart,SG,25,BOS,20,15,635,82,212,.387,42,126,.333,40,86,.465,.486,29,33,.879,19,48,67,91,26,9,25,46,235
Dennis Smith,PG,22,NYK,17,1,293,34,107,.318,10,33,.303,24,74,.324,.364,14,27,.519,12,21,33,46,7,5,26,37,92
Ish Smith,PG,31,WAS,24,10,609,96,211,.455,22,61,.361,74,150,.493,.507,13,20,.650,12,56,68,104,19,8,32,39,227
Tony Snell,SF,28,DET,22,20,569,64,134,.478,45,97,.464,19,37,.514,.646,8,8,1.000,5,37,42,29,9,3,10,40,181
Omari Spellman,PF,22,GSW,27,0,491,71,163,.436,19,54,.352,52,109,.477,.494,38,46,.826,57,87,144,26,17,16,36,28,199
Max Strus,SG,23,CHI,2,0,6,2,3,.667,0,1,.000,2,2,1.000,.667,1,1,1.000,1,0,1,0,0,0,0,1,5
Edmond Sumner,PG,24,IND,5,2,75,10,22,.455,1,5,.200,9,17,.529,.477,3,5,.600,1,2,3,9,5,1,2,9,24
Caleb Swanigan,PF,22,SAC,5,0,13,1,2,.500,0,0,0,1,2,.500,.500,1,2,.500,1,4,5,0,1,2,4,3,3
Jayson Tatum,PF,21,BOS,24,24,821,177,436,.406,60,165,.364,117,271,.432,.475,81,97,.835,28,139,167,69,34,18,53,55,495
Jeff Teague,PG,31,MIN,21,12,623,96,206,.466,21,55,.382,75,151,.497,.517,90,103,.874,12,47,59,143,19,7,45,44,303
Garrett Temple,SG,33,BRK,26,17,731,98,236,.415,57,164,.348,41,72,.569,.536,23,30,.767,13,67,80,63,23,13,30,51,276
Daniel Theis,C,27,BOS,21,20,459,63,118,.534,7,21,.333,56,97,.577,.564,22,32,.688,34,98,132,27,9,32,17,66,155
Isaiah Thomas,PG,30,WAS,17,14,424,82,184,.446,34,83,.410,48,101,.475,.538,16,20,.800,3,28,31,86,8,4,37,37,214
Khyri Thomas,SG,23,DET,2,0,6,0,0,0,0,0,0,0,0,0,0,1,2,.500,0,0,0,0,0,0,0,0,1
Matt Thomas,SG,25,TOR,12,0,136,20,37,.541,14,26,.538,6,11,.545,.730,3,5,.600,1,12,13,4,4,0,4,12,57
Tristan Thompson,C,28,CLE,25,25,774,141,274,.515,3,7,.429,138,267,.517,.520,43,78,.551,102,143,245,58,21,28,43,62,328
Matisse Thybulle,SG,22,PHI,27,3,485,44,101,.436,28,60,.467,16,41,.390,.574,15,22,.682,8,24,32,36,39,20,26,58,131
Anthony Tolliver,PF,34,POR,18,7,287,18,61,.295,14,48,.292,4,13,.308,.410,9,11,.818,10,45,55,11,4,6,11,23,59
Karl-Anthony Towns,C,24,MIN,23,23,779,207,403,.514,82,196,.418,125,207,.604,.615,113,142,.796,63,206,269,101,24,29,72,80,609
Gary Trent,SG,21,POR,13,1,108,15,41,.366,11,26,.423,4,15,.267,.500,0,0,0,3,13,16,5,3,2,3,8,41
Allonzo Trier,PG,24,NYK,12,1,157,28,55,.509,14,32,.438,14,23,.609,.636,26,33,.788,1,16,17,16,2,3,17,22,96
P.J. Tucker,PF,34,HOU,26,26,934,89,183,.486,51,121,.421,38,62,.613,.626,19,24,.792,39,145,184,38,35,12,30,87,248
Evan Turner,PG,31,ATL,15,0,208,23,59,.390,0,5,.000,23,54,.426,.390,12,14,.857,7,25,32,33,8,8,23,16,58
Myles Turner,C,23,IND,19,19,568,78,184,.424,26,80,.325,52,104,.500,.495,28,40,.700,27,82,109,23,11,45,31,47,210
Jonas Valančiūnas,C,27,MEM,24,24,594,134,240,.558,13,34,.382,121,206,.587,.585,38,50,.760,62,171,233,44,9,20,56,68,319
Denzel Valentine,SF,26,CHI,14,0,186,38,85,.447,23,53,.434,15,32,.469,.582,5,5,1.000,3,28,31,19,10,4,8,19,104
Jarred Vanderbilt,SF,20,DEN,3,0,9,0,0,0,0,0,0,0,0,0,0,0,0,0,0,2,2,1,0,0,1,0,0
Fred VanVleet,PG,25,TOR,22,22,806,126,308,.409,58,147,.395,68,161,.422,.503,85,97,.876,4,79,83,155,44,3,52,51,395
Noah Vonleh,C,24,MIN,16,1,181,20,43,.465,1,10,.100,19,33,.576,.477,16,19,.842,18,36,54,16,4,3,13,20,57
Nikola Vučević,C,29,ORL,15,15,460,103,226,.456,18,55,.327,85,171,.497,.496,35,41,.854,42,129,171,51,10,15,22,29,259
Dean Wade,PF,23,CLE,3,0,18,1,2,.500,1,1,1.000,0,1,.000,.750,0,0,0,0,2,2,0,1,0,0,3,3
Moritz Wagner,C,22,WAS,21,4,429,93,160,.581,22,56,.393,71,104,.683,.650,36,43,.837,34,93,127,28,15,13,43,81,244
Kemba Walker,PG,29,BOS,23,23,742,174,406,.429,87,214,.407,87,192,.453,.536,96,108,.889,21,76,97,122,22,13,49,39,531
Lonnie Walker,SG,21,SAS,18,0,173,36,75,.480,7,17,.412,29,58,.500,.527,12,20,.600,6,20,26,9,5,3,8,17,91
Tyrone Wallace,SG,25,ATL,14,0,160,14,44,.318,1,15,.067,13,29,.448,.330,11,17,.647,3,19,22,13,7,1,10,19,40
Taurean Waller-Prince,SF,25,BRK,26,26,790,122,310,.394,68,173,.393,54,137,.394,.503,24,33,.727,22,141,163,60,24,10,56,72,336
Derrick Walton,PG,24,LAC,12,0,128,9,18,.500,5,12,.417,4,6,.667,.639,6,7,.857,2,5,7,12,4,0,2,11,29
Brad Wanamaker,PG,30,BOS,24,0,430,57,121,.471,12,30,.400,45,91,.495,.521,48,55,.873,11,38,49,67,17,6,29,41,174
T.J. Warren,SF,26,IND,27,27,879,192,383,.501,33,87,.379,159,296,.537,.544,63,77,.818,19,74,93,29,29,7,37,74,480
PJ Washington,PF,21,CHO,28,28,823,127,264,.481,39,96,.406,88,168,.524,.555,50,71,.704,26,121,147,49,28,26,38,78,343
Yuta Watanabe,SG,25,MEM,4,0,18,3,6,.500,1,2,.500,2,4,.500,.583,0,0,0,1,4,5,0,0,1,1,1,7
Tremont Waters,PG,22,BOS,1,0,20,2,7,.286,1,5,.200,1,2,.500,.357,2,2,1.000,0,2,2,3,1,2,2,2,7
Russell Westbrook,PG,31,HOU,23,23,794,193,454,.425,27,116,.233,166,338,.491,.455,104,137,.759,37,147,184,169,38,8,100,89,517
Coby White,SG,19,CHI,28,0,691,116,326,.356,52,159,.327,64,167,.383,.436,38,48,.792,8,92,100,68,21,1,42,38,322
Derrick White,SG,25,SAS,23,10,554,79,170,.465,20,52,.385,59,118,.500,.524,44,55,.800,11,42,53,66,11,15,27,56,222
Hassan Whiteside,C,30,POR,23,23,653,154,249,.618,1,1,1.000,153,248,.617,.620,63,82,.768,84,202,286,32,10,56,43,68,372
Andrew Wiggins,SF,24,MIN,21,21,735,197,427,.461,46,138,.333,151,289,.522,.515,85,114,.746,26,81,107,69,15,24,43,51,525
Grant Williams,PF,21,BOS,22,1,308,15,60,.250,1,26,.038,14,34,.412,.258,14,17,.824,15,34,49,18,8,12,17,44,45
Kenrich Williams,PF,25,NOP,25,15,629,46,119,.387,23,80,.288,23,39,.590,.483,9,24,.375,39,107,146,47,20,20,19,66,124
Lou Williams,SG,33,LAC,26,3,807,170,413,.412,45,129,.349,125,284,.440,.466,133,158,.842,12,72,84,162,14,4,80,41,518
Marvin Williams,PF,33,CHO,24,0,487,63,127,.496,30,75,.400,33,52,.635,.614,27,30,.900,9,57,66,23,16,10,16,40,183
Robert Williams,C,22,BOS,19,1,269,33,49,.673,0,0,0,33,49,.673,.673,8,14,.571,23,64,87,21,17,21,16,34,74
Nigel Williams-Goss,PG,25,UTA,7,0,22,0,5,.000,0,1,.000,0,4,.000,.000,2,2,1.000,1,1,2,2,0,1,1,1,2
D.J. Wilson,PF,23,MIL,14,0,165,28,56,.500,11,35,.314,17,21,.810,.598,1,1,1.000,5,26,31,11,0,2,7,14,68
Justise Winslow,SF,23,MIA,10,5,337,50,127,.394,6,26,.231,44,101,.436,.417,18,27,.667,16,55,71,43,6,4,23,36,124
Christian Wood,PF,24,DET,24,0,366,81,129,.628,15,34,.441,66,95,.695,.686,41,62,.661,30,89,119,13,7,20,23,22,218
Delon Wright,SG,27,DAL,23,2,474,62,130,.477,13,37,.351,49,93,.527,.527,28,34,.824,18,59,77,76,26,7,16,28,165
Thaddeus Young,PF,31,CHI,27,0,587,102,244,.418,30,89,.337,72,155,.465,.480,18,32,.563,41,77,118,48,27,7,44,47,252
Trae Young,PG,21,ATL,26,26,908,237,535,.443,86,234,.368,151,301,.502,.523,162,189,.857,14,96,110,222,32,2,127,40,722
Cody Zeller,C,27,CHO,26,18,613,119,220,.541,15,46,.326,104,174,.598,.575,49,71,.690,77,129,206,32,14,12,39,64,302
Ante Žižić,C,23,CLE,9,0,91,16,29,.552,0,0,0,16,29,.552,.552,5,6,.833,7,16,23,0,2,2,1,10,37
Ivica Zubac,C,22,LAC,28,26,466,87,150,.580,0,2,.000,87,148,.588,.580,53,67,.791,64,120,184,24,5,30,25,67,227
