,Player,Pos,Age,Tm,G,GS,MP,FG,FGA,FG%,3P,3PA,3P%,2P,2PA,2P%,eFG%,FT,FTA,FT%,ORB,DRB,TRB,AST,STL,BLK,TOV,PF,PTS
0,Steven Adams,C,26,OKC,20,20,542,92,149,0.617,0,1,0.0,92,148,0.622,0.617,32,59,0.542,60,126,186,58,10,25,29,38,216
1,Bam Adebayo,C,22,MIA,23,23,761,124,214,0.579,1,7,0.14300000000000002,123,207,0.594,0.5820000000000001,87,132,0.659,57,185,242,94,32,28,68,59,336
2,LaMarcus Aldridge,C,34,SAS,21,21,691,161,314,0.513,12,33,0.364,149,281,0.53,0.532,62,74,0.838,44,103,147,51,13,37,34,46,396
3,Nickeil Alexander-Walker,SG,21,NOP,20,0,281,46,141,0.326,24,75,0.32,22,66,0.33299999999999996,0.41100000000000003,11,16,0.688,4,41,45,39,7,2,23,26,127
4,Grayson Allen,SG,24,MEM,13,0,246,38,92,0.413,15,43,0.349,23,49,0.469,0.495,15,17,0.882,2,36,38,19,5,1,15,21,106
5,Jarrett Allen,C,21,BRK,23,20,610,112,169,0.6629999999999999,0,1,0.0,112,168,0.667,0.6629999999999999,60,100,0.6,85,158,243,27,18,30,28,57,284
6,Kadeem Allen,SG,27,NYK,1,0,16,3,6,0.5,3,4,0.75,0,2,0.0,0.75,0,0,0.0,0,0,0,2,1,0,1,1,9
7,Al-Farouq Aminu,PF,29,ORL,18,2,380,25,86,0.29100000000000004,9,36,0.25,16,50,0.32,0.34299999999999997,19,29,0.655,24,63,87,21,18,8,17,27,78
8,Kyle Anderson,PF,26,MEM,17,0,348,47,93,0.505,4,16,0.25,43,77,0.5579999999999999,0.527,16,28,0.5710000000000001,16,59,75,44,12,12,15,29,114
9,Ryan Anderson,PF,31,HOU,2,0,14,2,7,0.28600000000000003,1,5,0.2,1,2,0.5,0.35700000000000004,0,0,0.0,0,7,7,2,1,0,1,1,5
10,Giannis Antetokounmpo,PF,25,MIL,24,24,758,275,488,0.564,38,119,0.319,237,369,0.642,0.602,153,260,0.588,65,252,317,133,31,31,91,77,741
11,Kostas Antetokounmpo,PF,22,LAL,2,0,3,0,0,0.0,0,0,0.0,0,0,0.0,0.0,0,0,0.0,0,1,1,0,0,0,0,0,0
12,Thanasis Antetokounmpo,SF,27,MIL,4,0,25,6,10,0.6,0,0,0.0,6,10,0.6,0.6,2,4,0.5,3,0,3,4,0,0,2,3,14
13,Carmelo Anthony,PF,35,POR,10,10,318,60,147,0.408,14,39,0.359,46,108,0.426,0.456,25,29,0.862,10,48,58,15,11,2,21,33,159
14,OG Anunoby,SF,22,TOR,22,22,658,98,188,0.521,34,81,0.42,64,107,0.598,0.612,16,29,0.552,22,101,123,40,30,20,25,51,246
15,Ryan Arcidiacono,PG,25,CHI,25,0,393,32,88,0.364,22,56,0.39299999999999996,10,32,0.313,0.489,15,20,0.75,13,27,40,41,12,2,17,47,101
16,Trevor Ariza,SF,34,SAC,16,0,355,28,78,0.359,21,60,0.35,7,18,0.389,0.494,9,12,0.75,7,54,61,19,16,3,12,27,86
17,D.J. Augustin,PG,32,ORL,23,5,589,74,195,0.379,24,80,0.3,50,115,0.435,0.441,52,59,0.8809999999999999,11,44,55,109,18,0,33,25,224
18,Deandre Ayton,C,21,PHO,1,1,33,9,14,0.643,0,0,0.0,9,14,0.643,0.643,0,0,0.0,3,8,11,0,1,4,0,2,18
19,Dwayne Bacon,SG,24,CHO,19,10,375,49,153,0.32,10,42,0.23800000000000002,39,111,0.35100000000000003,0.353,20,29,0.69,8,42,50,24,15,2,19,32,128
20,Marvin Bagley,PF,20,SAC,1,1,28,6,16,0.375,0,0,0.0,6,16,0.375,0.375,2,4,0.5,4,6,10,0,1,1,1,1,14
21,Lonzo Ball,PG,22,NOP,16,12,461,63,165,0.382,34,100,0.34,29,65,0.446,0.485,10,14,0.7140000000000001,13,59,72,90,17,6,42,33,170
22,Mo Bamba,C,21,ORL,21,0,324,45,109,0.413,15,41,0.366,30,68,0.441,0.48200000000000004,5,10,0.5,27,81,108,9,6,30,26,46,110
23,J.J. Barea,PG,35,DAL,6,0,84,20,45,0.444,10,17,0.588,10,28,0.35700000000000004,0.556,2,2,1.0,2,8,10,17,2,1,5,2,52
24,Harrison Barnes,PF,27,SAC,23,23,816,129,274,0.47100000000000003,31,86,0.36,98,188,0.521,0.527,89,111,0.802,26,96,122,53,21,5,37,29,378
25,RJ Barrett,SG,19,NYK,22,22,707,117,296,0.395,22,71,0.31,95,225,0.42200000000000004,0.43200000000000005,59,111,0.532,26,91,117,72,30,11,54,55,315
26,Will Barton,SF,29,DEN,19,19,611,101,225,0.449,36,87,0.414,65,138,0.47100000000000003,0.529,31,43,0.721,30,94,124,62,19,7,24,41,269
27,Keita Bates-Diop,SF,24,MIN,12,0,230,35,67,0.522,17,35,0.486,18,32,0.563,0.649,6,10,0.6,6,28,34,8,4,6,5,13,93
28,Nicolas Batum,SF,31,CHO,13,0,293,16,44,0.364,9,33,0.273,7,11,0.636,0.466,5,5,1.0,15,42,57,42,11,7,19,22,46
29,Aron Baynes,C,33,PHO,14,12,328,76,136,0.5589999999999999,27,64,0.42200000000000004,49,72,0.6809999999999999,0.6579999999999999,24,34,0.706,20,58,78,39,4,10,15,55,203
30,Kent Bazemore,SF,30,POR,24,3,552,62,180,0.344,31,87,0.35600000000000004,31,93,0.33299999999999996,0.431,34,43,0.7909999999999999,10,93,103,40,21,18,34,73,189
31,Darius Bazley,PF,19,OKC,23,1,394,33,85,0.38799999999999996,15,42,0.35700000000000004,18,43,0.419,0.47600000000000003,11,18,0.611,8,79,87,12,8,10,18,22,92
32,Bradley Beal,SG,26,WAS,22,22,813,212,468,0.45299999999999996,58,169,0.34299999999999997,154,299,0.515,0.515,133,159,0.836,22,78,100,153,21,5,77,59,615
33,Malik Beasley,SG,23,DEN,17,0,271,41,108,0.38,21,51,0.41200000000000003,20,57,0.35100000000000003,0.47700000000000004,6,7,0.857,5,20,25,18,8,2,16,19,109
34,Marco Belinelli,SG,33,SAS,21,0,340,39,124,0.315,21,63,0.33299999999999996,18,61,0.295,0.39899999999999997,15,21,0.7140000000000001,1,34,35,32,5,0,9,17,114
35,Jordan Bell,C,25,MIN,13,0,125,18,33,0.545,0,5,0.0,18,28,0.643,0.545,11,19,0.579,13,33,46,8,0,6,14,10,47
36,DeAndre' Bembry,SG,25,ATL,23,4,588,71,145,0.49,9,36,0.25,62,109,0.569,0.521,18,37,0.486,25,80,105,63,33,11,35,51,169
37,Dragan Bender,SF,22,MIL,3,0,29,6,8,0.75,2,4,0.5,4,4,1.0,0.875,1,1,1.0,0,2,2,3,0,2,1,6,15
38,Dāvis Bertāns,PF,27,WAS,22,1,635,109,235,0.46399999999999997,84,186,0.452,25,49,0.51,0.643,26,30,0.867,20,79,99,35,14,13,14,55,328
39,Patrick Beverley,PG,31,LAC,23,23,688,65,164,0.396,31,98,0.316,34,66,0.515,0.491,14,23,0.609,32,115,147,75,34,12,34,87,175
40,Khem Birch,C,27,ORL,14,9,319,23,47,0.489,0,1,0.0,23,46,0.5,0.489,13,26,0.5,31,50,81,16,8,11,11,37,59
41,Goga Bitadze,C,20,IND,18,2,218,26,57,0.456,4,14,0.28600000000000003,22,43,0.512,0.491,14,19,0.737,16,36,52,14,1,19,10,33,70
42,Bismack Biyombo,C,27,CHO,23,8,381,67,118,0.568,0,0,0.0,67,118,0.568,0.568,39,69,0.565,37,62,99,19,6,17,15,44,173
43,Nemanja Bjelica,PF,31,SAC,23,22,609,105,219,0.479,43,101,0.426,62,118,0.525,0.578,16,17,0.941,45,111,156,62,24,13,39,69,269
44,Eric Bledsoe,PG,30,MIL,24,24,650,134,289,0.46399999999999997,27,86,0.314,107,203,0.527,0.51,55,70,0.7859999999999999,21,100,121,137,19,12,55,57,350
45,Bogdan Bogdanović,SG,27,SAC,21,0,576,105,261,0.402,55,146,0.377,50,115,0.435,0.508,33,46,0.7170000000000001,6,53,59,89,26,2,37,38,298
46,Bojan Bogdanović,SF,30,UTA,23,23,761,160,351,0.456,72,159,0.45299999999999996,88,192,0.45799999999999996,0.5579999999999999,81,92,0.88,16,86,102,46,17,4,62,45,473
47,Jonah Bolden,PF,24,PHI,2,0,5,1,1,1.0,0,0,0.0,1,1,1.0,1.0,0,2,0.0,0,0,0,0,1,0,1,0,2
48,Jordan Bone,PG,22,DET,3,0,6,2,5,0.4,0,1,0.0,2,4,0.5,0.4,0,0,0.0,0,0,0,0,0,0,2,2,4
49,Isaac Bonga,SF,20,WAS,17,11,264,25,49,0.51,4,13,0.308,21,36,0.583,0.551,10,13,0.769,11,32,43,23,11,3,9,35,64
50,Devin Booker,SG,23,PHO,23,23,822,207,403,0.514,54,130,0.415,153,273,0.56,0.581,118,130,0.9079999999999999,14,75,89,144,14,8,90,71,586
51,Chris Boucher,PF,27,TOR,20,0,240,39,86,0.45299999999999996,10,31,0.32299999999999995,29,55,0.527,0.512,20,29,0.69,40,45,85,10,7,15,8,27,108
52,Brian Bowen,SG,21,IND,3,0,10,1,4,0.25,0,1,0.0,1,3,0.33299999999999996,0.25,0,0,0.0,0,1,1,0,0,1,0,0,2
53,Ky Bowman,PG,22,GSW,25,6,580,87,192,0.45299999999999996,27,64,0.42200000000000004,60,128,0.469,0.523,19,20,0.95,13,56,69,70,23,3,31,54,220
54,Avery Bradley,SG,29,LAL,10,10,274,41,84,0.488,8,28,0.28600000000000003,33,56,0.589,0.536,6,8,0.75,7,25,32,18,10,1,11,26,96
55,Tony Bradley,C,22,UTA,18,2,164,33,54,0.611,0,0,0.0,33,54,0.611,0.611,11,16,0.688,25,38,63,5,2,8,8,28,77
56,Jarrell Brantley,PF,23,UTA,2,0,9,0,0,0.0,0,0,0.0,0,0,0.0,0.0,0,0,0.0,0,4,4,1,0,2,1,1,0
57,Ignas Brazdeikis,SF,21,NYK,6,0,42,5,19,0.263,1,7,0.14300000000000002,4,12,0.33299999999999996,0.289,3,4,0.75,2,2,4,1,0,1,2,2,14
58,Mikal Bridges,SF,23,PHO,23,0,485,61,122,0.5,12,39,0.308,49,83,0.59,0.5489999999999999,33,42,0.7859999999999999,21,64,85,26,32,8,19,43,167
59,Miles Bridges,SF,21,CHO,25,25,765,124,275,0.451,41,107,0.38299999999999995,83,168,0.494,0.525,30,38,0.789,35,99,134,44,12,18,41,50,319
60,Oshae Brissett,SF,21,TOR,4,0,17,1,3,0.33299999999999996,1,1,1.0,0,2,0.0,0.5,0,0,0.0,0,1,1,1,1,0,1,0,3
61,Ryan Broekhoff,SG,29,DAL,4,0,25,4,8,0.5,4,5,0.8,0,3,0.0,0.75,0,0,0.0,0,5,5,3,1,0,1,1,12
62,Malcolm Brogdon,PG,27,IND,20,20,635,139,294,0.473,30,87,0.345,109,207,0.527,0.524,73,78,0.9359999999999999,12,81,93,149,19,4,58,42,381
63,Dillon Brooks,SG,24,MEM,23,23,632,111,280,0.396,39,107,0.364,72,173,0.41600000000000004,0.466,44,55,0.8,24,56,80,45,25,8,28,87,305
64,Bruce Brown,SG,23,DET,24,20,632,71,167,0.425,13,39,0.33299999999999996,58,128,0.45299999999999996,0.46399999999999997,22,39,0.564,21,82,103,86,22,12,43,64,177
65,Charlie Brown,SG,22,ATL,4,0,16,1,3,0.33299999999999996,1,1,1.0,0,2,0.0,0.5,4,4,1.0,2,1,3,0,0,1,0,0,7
66,Jaylen Brown,SF,23,BOS,19,19,634,144,287,0.502,38,101,0.376,106,186,0.57,0.568,54,74,0.73,20,112,132,37,21,7,31,61,380
67,Moses Brown,C,20,POR,4,0,15,3,7,0.429,0,0,0.0,3,7,0.429,0.429,2,4,0.5,2,7,9,0,1,0,1,4,8
68,Sterling Brown,SF,24,MIL,16,0,264,32,76,0.42100000000000004,16,41,0.39,16,35,0.457,0.526,10,15,0.667,11,65,76,23,10,2,16,22,90
69,Troy Brown,SG,20,WAS,19,11,414,60,129,0.465,9,35,0.257,51,94,0.5429999999999999,0.5,15,21,0.7140000000000001,27,69,96,40,25,3,17,29,144
70,Jalen Brunson,PG,23,DAL,23,3,360,68,137,0.496,14,43,0.326,54,94,0.574,0.547,22,31,0.71,13,41,54,59,11,0,20,26,172
71,Thomas Bryant,C,22,WAS,18,18,511,101,184,0.5489999999999999,10,35,0.28600000000000003,91,149,0.611,0.5760000000000001,39,53,0.736,42,111,153,48,8,18,24,44,251
72,Trey Burke,PG,27,PHI,9,0,152,25,58,0.431,6,16,0.375,19,42,0.452,0.483,8,11,0.727,6,7,13,31,7,1,4,7,64
73,Alec Burks,SG,28,GSW,22,10,643,110,262,0.42,32,90,0.35600000000000004,78,172,0.45299999999999996,0.48100000000000004,80,90,0.889,15,84,99,65,24,6,32,48,332
74,Deonte Burton,SG,26,OKC,12,0,101,13,33,0.39399999999999996,5,17,0.294,8,16,0.5,0.47,3,4,0.75,3,18,21,4,1,1,4,11,34
75,Jimmy Butler,SF,30,MIA,19,19,660,111,257,0.43200000000000005,20,66,0.303,91,191,0.47600000000000003,0.47100000000000003,150,178,0.843,39,80,119,129,42,15,49,27,392
76,Bruno Caboclo,SF,24,MEM,15,0,160,26,59,0.441,4,20,0.2,22,39,0.564,0.475,2,3,0.667,14,21,35,8,7,11,7,17,58
77,Kentavious Caldwell-Pope,SG,26,LAL,24,14,576,72,160,0.45,27,71,0.38,45,89,0.506,0.534,20,24,0.833,11,40,51,42,18,4,20,40,191
78,Vlatko Čančar,SF,22,DEN,1,0,2,0,0,0.0,0,0,0.0,0,0,0.0,0.0,0,0,0.0,0,0,0,0,0,0,0,0,0
79,Clint Capela,C,25,HOU,19,19,620,122,189,0.6459999999999999,0,0,0.0,122,189,0.6459999999999999,0.6459999999999999,28,60,0.467,82,199,281,19,16,35,34,55,272
80,DeMarre Carroll,SF,33,SAS,11,0,120,7,25,0.28,3,12,0.25,4,13,0.308,0.34,10,14,0.7140000000000001,7,22,29,10,2,2,9,17,27
81,Jevon Carter,PG,24,PHO,16,2,225,22,55,0.4,14,34,0.41200000000000003,8,21,0.381,0.527,4,4,1.0,3,24,27,28,13,5,15,24,62
82,Vince Carter,SF,43,ATL,18,0,275,38,102,0.373,18,67,0.26899999999999996,20,35,0.5710000000000001,0.461,6,8,0.75,4,30,34,14,6,6,11,31,100
83,Wendell Carter,C,20,CHI,25,25,749,117,206,0.568,2,15,0.133,115,191,0.602,0.573,69,98,0.7040000000000001,88,157,245,24,18,20,38,103,305
84,Michael Carter-Williams,SG,28,ORL,13,0,197,18,57,0.316,3,19,0.158,15,38,0.395,0.342,19,23,0.826,14,28,42,22,12,6,13,19,58
85,Alex Caruso,PG,25,LAL,22,0,454,48,107,0.449,16,46,0.348,32,61,0.525,0.523,13,20,0.65,3,42,45,44,24,7,23,36,125
86,Willie Cauley-Stein,C,26,GSW,22,21,493,78,140,0.557,0,0,0.0,78,140,0.557,0.557,21,31,0.677,33,111,144,35,23,27,21,63,177
87,Tyson Chandler,C,37,HOU,18,4,163,13,17,0.765,0,0,0.0,13,17,0.765,0.765,5,9,0.556,19,30,49,6,5,7,6,24,31
88,Zylan Cheatham,SF,24,NOP,2,0,20,1,4,0.25,0,1,0.0,1,3,0.33299999999999996,0.25,0,0,0.0,0,3,3,1,0,0,1,3,2
89,Chris Chiozza,PG,24,WAS,8,0,91,5,23,0.217,3,6,0.5,2,17,0.11800000000000001,0.28300000000000003,0,0,0.0,0,9,9,24,7,2,7,8,13
90,Marquese Chriss,PF,22,GSW,24,1,425,61,129,0.473,4,19,0.21100000000000002,57,110,0.518,0.488,43,50,0.86,33,79,112,46,17,22,35,48,169
91,Gary Clark,PF,25,HOU,8,0,93,11,28,0.39299999999999996,8,23,0.348,3,5,0.6,0.536,2,2,1.0,6,14,20,5,1,3,1,9,32
92,Brandon Clarke,PF,23,MEM,18,2,381,92,146,0.63,10,22,0.455,82,124,0.6609999999999999,0.664,19,23,0.826,24,82,106,23,9,17,19,31,213
93,Jordan Clarkson,SG,27,CLE,23,0,510,104,250,0.41600000000000004,41,118,0.34700000000000003,63,132,0.47700000000000004,0.498,67,75,0.893,14,37,51,56,12,6,32,26,316
94,Nicolas Claxton,PF,20,BRK,9,0,119,11,21,0.524,0,5,0.0,11,16,0.688,0.524,5,12,0.41700000000000004,8,14,22,11,1,5,6,10,27
95,Chris Clemons,SG,22,HOU,16,0,134,24,59,0.40700000000000003,18,47,0.38299999999999995,6,12,0.5,0.5589999999999999,3,4,0.75,2,8,10,6,3,2,6,14,69
96,John Collins,PF,22,ATL,5,5,161,32,61,0.525,9,19,0.474,23,42,0.5479999999999999,0.598,12,17,0.706,10,34,44,8,5,10,7,17,85
97,Zach Collins,PF,22,POR,3,3,86,9,19,0.474,3,7,0.429,6,12,0.5,0.5529999999999999,6,6,1.0,4,8,12,6,0,2,6,11,27
98,Mike Conley,PG,32,UTA,21,21,628,97,263,0.369,40,107,0.374,57,156,0.365,0.445,58,73,0.795,16,57,73,96,15,4,44,45,292
99,Pat Connaughton,SG,27,MIL,22,0,393,47,96,0.49,18,54,0.33299999999999996,29,42,0.69,0.583,13,17,0.765,11,78,89,42,8,11,13,23,125
100,Quinn Cook,PG,26,LAL,20,0,267,42,98,0.429,12,35,0.34299999999999997,30,63,0.47600000000000003,0.49,4,5,0.8,4,19,23,30,6,1,16,12,100
101,Tyler Cook,PF,22,CLE,6,0,17,5,6,0.833,0,0,0.0,5,6,0.833,0.833,2,2,1.0,3,2,5,0,1,0,1,1,12
102,Robert Covington,PF,29,MIN,22,22,611,92,202,0.455,45,122,0.369,47,80,0.588,0.5670000000000001,46,51,0.902,17,99,116,24,29,19,34,66,275
103,Allen Crabbe,SG,27,ATL,11,1,212,24,62,0.387,11,38,0.289,13,24,0.542,0.47600000000000003,5,7,0.7140000000000001,5,24,29,10,7,2,5,10,64
104,Torrey Craig,SF,29,DEN,14,2,192,14,41,0.341,4,20,0.2,10,21,0.47600000000000003,0.39,4,9,0.444,9,26,35,15,5,11,5,27,36
105,Jae Crowder,SF,29,MEM,23,23,713,80,207,0.386,48,150,0.32,32,57,0.561,0.502,34,46,0.7390000000000001,16,121,137,62,22,8,32,48,242
106,Jarrett Culver,SG,20,MIN,23,13,543,83,216,0.384,23,87,0.264,60,129,0.465,0.43799999999999994,23,51,0.451,24,54,78,54,21,12,31,49,212
107,Seth Curry,SG,29,DAL,21,9,445,56,130,0.431,31,81,0.38299999999999995,25,49,0.51,0.55,29,31,0.935,8,32,40,34,12,4,16,38,172
108,Stephen Curry,PG,31,GSW,4,4,112,27,66,0.409,9,37,0.243,18,29,0.621,0.47700000000000004,18,18,1.0,4,16,20,26,5,2,15,10,81
109,Troy Daniels,SG,28,LAL,19,0,271,33,90,0.36700000000000005,23,68,0.33799999999999997,10,22,0.455,0.494,3,4,0.75,4,23,27,7,7,1,6,14,92
110,Anthony Davis,PF,26,LAL,23,23,791,222,438,0.507,25,75,0.33299999999999996,197,363,0.5429999999999999,0.535,167,192,0.87,56,152,208,75,35,61,52,53,636
111,Ed Davis,C,30,UTA,12,0,147,9,20,0.45,0,0,0.0,9,20,0.45,0.45,3,6,0.5,14,40,54,5,5,6,9,28,21
112,Terence Davis,SG,22,TOR,23,0,360,55,113,0.48700000000000004,25,60,0.41700000000000004,30,53,0.5660000000000001,0.597,14,15,0.9329999999999999,14,54,68,43,10,6,18,42,149
113,Dewayne Dedmon,C,30,SAC,21,4,305,42,103,0.408,11,48,0.22899999999999998,31,55,0.564,0.461,11,13,0.846,26,59,85,8,9,11,31,55,106
114,Matthew Dellavedova,PG,29,CLE,21,0,275,18,65,0.27699999999999997,4,37,0.10800000000000001,14,28,0.5,0.308,12,13,0.9229999999999999,6,23,29,46,8,1,15,30,52
115,DeMar DeRozan,SF,30,SAS,23,23,787,189,372,0.508,5,14,0.35700000000000004,184,358,0.514,0.515,109,134,0.813,12,118,130,111,22,11,59,66,492
116,Cheick Diallo,C,23,PHO,17,0,174,41,59,0.695,1,1,1.0,40,58,0.69,0.703,15,17,0.882,14,38,52,9,2,4,8,20,98
117,Hamidou Diallo,SF,21,OKC,12,1,256,46,92,0.5,2,13,0.154,44,79,0.557,0.511,11,18,0.611,14,32,46,10,18,4,14,29,105
118,Gorgui Dieng,C,30,MIN,19,2,237,34,79,0.43,8,27,0.29600000000000004,26,52,0.5,0.48100000000000004,12,16,0.75,16,60,76,20,13,20,13,26,88
119,Spencer Dinwiddie,SG,26,BRK,23,12,684,156,366,0.426,43,138,0.312,113,228,0.496,0.485,119,140,0.85,5,62,67,142,20,11,62,79,474
120,Donte DiVincenzo,SG,23,MIL,21,10,441,69,160,0.431,28,79,0.354,41,81,0.506,0.519,20,26,0.769,18,70,88,32,32,3,23,35,186
121,Luka Dončić,PG,20,DAL,23,23,769,222,466,0.47600000000000003,70,219,0.32,152,247,0.615,0.552,175,215,0.8140000000000001,31,195,226,211,30,3,105,55,689
122,Luguentz Dort,SG,20,OKC,3,0,56,4,11,0.364,0,6,0.0,4,5,0.8,0.364,3,5,0.6,0,6,6,0,1,0,2,10,11
123,Damyean Dotson,SG,25,NYK,19,0,296,44,107,0.41100000000000003,19,62,0.306,25,45,0.556,0.5,10,13,0.769,3,27,30,19,9,4,11,18,117
124,Sekou Doumbouya,SF,19,DET,4,0,11,3,6,0.5,0,1,0.0,3,5,0.6,0.5,0,1,0.0,0,2,2,0,0,0,0,3,6
125,Goran Dragić,PG,33,MIA,18,1,517,97,208,0.466,39,96,0.406,58,112,0.518,0.56,54,76,0.711,6,52,58,90,12,4,47,32,287
126,Andre Drummond,C,26,DET,24,24,811,175,325,0.5379999999999999,0,12,0.0,175,313,0.5589999999999999,0.5379999999999999,69,108,0.639,113,288,401,72,40,45,87,92,419
127,Jared Dudley,SF,34,LAL,15,0,100,5,11,0.455,5,8,0.625,0,3,0.0,0.682,2,2,1.0,2,10,12,9,5,1,2,8,17
128,Kris Dunn,PG,25,CHI,25,6,542,72,171,0.42100000000000004,11,57,0.193,61,114,0.535,0.45299999999999996,13,18,0.722,14,66,80,73,48,7,26,89,168
129,Carsen Edwards,SG,21,BOS,20,0,228,26,82,0.317,16,49,0.327,10,33,0.303,0.415,11,13,0.846,5,30,35,17,7,2,12,22,79
130,Henry Ellenson,PF,23,BRK,1,0,3,0,0,0.0,0,0,0.0,0,0,0.0,0.0,0,0,0.0,0,0,0,0,0,0,0,0,0
131,Wayne Ellington,SG,32,NYK,18,1,257,26,81,0.321,21,69,0.304,5,12,0.41700000000000004,0.451,4,6,0.667,1,28,29,16,5,2,12,20,77
132,Joel Embiid,C,25,PHI,19,19,577,133,290,0.45899999999999996,21,67,0.313,112,223,0.502,0.495,130,161,0.807,48,189,237,56,17,26,64,66,417
133,James Ennis,SF,29,PHI,24,0,420,60,121,0.496,22,52,0.423,38,69,0.551,0.5870000000000001,36,46,0.7829999999999999,27,56,83,22,13,7,15,46,178
134,Drew Eubanks,PF,22,SAS,4,0,31,5,10,0.5,0,0,0.0,5,10,0.5,0.5,1,1,1.0,5,8,13,2,0,1,4,4,11
135,Jacob Evans,SG,22,GSW,4,0,54,6,16,0.375,4,8,0.5,2,8,0.25,0.5,4,4,1.0,1,5,6,3,0,0,2,4,20
136,Dante Exum,SG,24,UTA,11,0,83,10,23,0.435,2,6,0.33299999999999996,8,17,0.47100000000000003,0.478,2,2,1.0,3,9,12,7,1,2,10,8,24
137,Tacko Fall,C,24,BOS,1,0,4,2,4,0.5,0,0,0.0,2,4,0.5,0.5,0,0,0.0,0,3,3,0,0,0,1,2,4
138,Derrick Favors,C,28,NOP,9,7,189,36,58,0.621,1,2,0.5,35,56,0.625,0.629,2,6,0.33299999999999996,31,49,80,19,5,4,14,21,75
139,Terrance Ferguson,SF,21,OKC,19,19,497,39,92,0.424,23,65,0.354,16,27,0.593,0.5489999999999999,7,9,0.778,11,25,36,19,10,6,14,57,108
140,Bruno Fernando,C,21,ATL,23,0,275,40,73,0.5479999999999999,4,15,0.267,36,58,0.621,0.575,13,22,0.591,27,39,66,24,5,9,21,36,97
141,Yogi Ferrell,PG,26,SAC,19,0,265,40,89,0.449,9,30,0.3,31,59,0.525,0.5,25,29,0.862,4,21,25,35,8,1,13,17,114
142,Dorian Finney-Smith,PF,26,DAL,23,20,618,73,155,0.47100000000000003,28,85,0.32899999999999996,45,70,0.643,0.561,24,34,0.706,43,73,116,25,14,10,24,43,198
143,Bryn Forbes,SG,26,SAS,23,23,619,105,251,0.418,55,152,0.36200000000000004,50,99,0.505,0.528,31,37,0.838,7,50,57,46,12,0,16,44,296
144,Evan Fournier,SG,27,ORL,23,23,707,159,329,0.483,64,143,0.44799999999999995,95,186,0.511,0.581,78,92,0.848,4,64,68,73,22,4,47,53,460
145,De'Aaron Fox,PG,22,SAC,9,9,288,55,128,0.43,10,30,0.33299999999999996,45,98,0.45899999999999996,0.469,44,62,0.71,5,31,36,63,7,5,37,27,164
146,Melvin Frazier,SG,23,ORL,4,0,11,1,6,0.16699999999999998,0,1,0.0,1,5,0.2,0.16699999999999998,0,0,0.0,1,0,1,1,0,0,0,1,2
147,Tim Frazier,PG,29,DET,13,4,138,9,42,0.214,3,14,0.214,6,28,0.214,0.25,11,14,0.7859999999999999,4,9,13,38,8,2,12,18,32
148,Markelle Fultz,PG,21,ORL,23,18,593,113,236,0.479,8,38,0.21100000000000002,105,198,0.53,0.496,42,53,0.792,10,53,63,94,29,4,42,49,276
149,Wenyen Gabriel,PF,22,SAC,7,0,47,5,16,0.313,1,8,0.125,4,8,0.5,0.344,5,9,0.556,4,4,8,3,2,2,3,6,16
150,Daniel Gafford,C,21,CHI,16,0,169,32,43,0.7440000000000001,0,0,0.0,32,43,0.7440000000000001,0.7440000000000001,10,21,0.47600000000000003,14,15,29,2,1,14,2,23,74
151,Danilo Gallinari,PF,31,OKC,22,22,668,123,276,0.446,60,149,0.40299999999999997,63,127,0.496,0.5539999999999999,96,105,0.914,12,114,126,46,15,3,31,35,402
152,Langston Galloway,SG,28,DET,24,6,662,96,213,0.451,61,142,0.43,35,71,0.493,0.594,45,50,0.9,9,42,51,37,14,7,19,30,298
153,Darius Garland,PG,20,CLE,23,23,648,95,253,0.375,37,103,0.359,58,150,0.387,0.449,23,27,0.852,8,34,42,65,16,0,57,33,250
154,Marc Gasol,C,35,TOR,23,23,662,49,144,0.34,27,77,0.35100000000000003,22,67,0.32799999999999996,0.434,19,24,0.792,17,129,146,81,15,27,31,77,144
155,Rudy Gay,PF,33,SAS,23,4,532,96,209,0.45899999999999996,20,73,0.27399999999999997,76,136,0.5589999999999999,0.507,48,54,0.889,31,105,136,44,10,13,38,34,260
156,Paul George,SF,29,LAC,14,14,416,108,242,0.446,57,136,0.419,51,106,0.48100000000000004,0.564,62,68,0.912,7,82,89,50,20,6,48,36,335
157,Taj Gibson,C,34,NYK,21,15,344,50,96,0.521,2,9,0.222,48,87,0.552,0.531,9,15,0.6,41,52,93,25,14,5,14,46,111
158,Harry Giles,PF,21,SAC,7,0,52,11,25,0.44,0,0,0.0,11,25,0.44,0.44,2,2,1.0,3,4,7,5,2,3,5,13,24
159,Shai Gilgeous-Alexander,SG,21,OKC,23,23,802,156,361,0.43200000000000005,34,95,0.358,122,266,0.45899999999999996,0.479,86,108,0.7959999999999999,16,103,119,69,23,10,49,42,432
160,Rudy Gobert,C,27,UTA,22,22,745,121,178,0.68,0,0,0.0,121,178,0.68,0.68,75,122,0.615,74,224,298,30,17,39,49,70,317
161,Brandon Goodwin,PG,24,ATL,2,0,5,0,1,0.0,0,1,0.0,0,0,0.0,0.0,0,0,0.0,0,0,0,0,0,0,2,1,0
162,Aaron Gordon,PF,24,ORL,20,20,623,100,236,0.424,25,80,0.313,75,156,0.48100000000000004,0.47700000000000004,48,67,0.716,31,105,136,57,14,10,28,43,273
163,Eric Gordon,SG,31,HOU,9,2,265,34,110,0.309,21,74,0.284,13,36,0.361,0.405,9,14,0.643,3,14,17,7,5,2,12,21,98
164,Devonte' Graham,PG,24,CHO,25,15,841,153,379,0.40399999999999997,90,217,0.415,63,162,0.389,0.522,75,93,0.8059999999999999,27,67,94,194,17,5,77,41,471
165,Treveon Graham,SG,26,MIN,22,17,484,47,136,0.34600000000000003,13,62,0.21,34,74,0.45899999999999996,0.39299999999999996,19,24,0.792,23,53,76,23,14,2,13,49,126
166,Jerami Grant,PF,25,DEN,21,0,464,74,163,0.45399999999999996,26,72,0.361,48,91,0.527,0.534,25,42,0.595,11,62,73,21,7,12,18,37,199
167,Josh Gray,PG,26,NOP,2,0,23,1,2,0.5,0,0,0.0,1,2,0.5,0.5,0,0,0.0,1,1,2,2,0,0,5,1,2
168,Danny Green,SG,32,LAL,24,24,607,71,164,0.433,47,118,0.39799999999999996,24,46,0.522,0.5760000000000001,8,11,0.727,15,76,91,29,31,12,23,58,197
169,Draymond Green,PF,29,GSW,16,16,451,51,126,0.405,11,40,0.275,40,86,0.465,0.44799999999999995,28,39,0.718,7,88,95,89,25,11,37,42,141
170,JaMychal Green,PF,29,LAC,22,0,469,55,133,0.414,34,90,0.37799999999999995,21,43,0.488,0.541,18,21,0.857,29,116,145,10,13,7,20,54,162
171,Javonte Green,SF,26,BOS,16,0,111,21,35,0.6,3,10,0.3,18,25,0.72,0.643,2,5,0.4,3,12,15,4,4,2,3,11,47
172,Jeff Green,PF,33,UTA,24,2,456,63,158,0.39899999999999997,30,86,0.349,33,72,0.45799999999999996,0.494,43,54,0.7959999999999999,10,56,66,15,10,10,25,42,199
173,Blake Griffin,PF,30,DET,12,12,352,69,173,0.39899999999999997,22,71,0.31,47,102,0.461,0.462,58,75,0.773,12,47,59,39,5,4,33,17,218
174,Marko Guduric,SG,24,MEM,23,0,347,45,116,0.38799999999999996,17,57,0.298,28,59,0.475,0.461,13,15,0.867,11,36,47,33,8,5,24,22,120
175,Rui Hachimura,PF,21,WAS,22,22,651,132,273,0.484,9,44,0.205,123,229,0.537,0.5,40,45,0.889,34,93,127,38,17,3,19,49,313
176,Devon Hall,SG,24,OKC,5,0,20,1,5,0.2,0,2,0.0,1,3,0.33299999999999996,0.2,3,4,0.75,0,1,1,3,0,0,1,1,5
177,Tim Hardaway,SG,27,DAL,23,10,570,103,238,0.433,56,147,0.381,47,91,0.516,0.55,41,50,0.82,7,42,49,41,14,3,12,44,303
178,James Harden,SG,30,HOU,23,23,868,238,552,0.431,107,317,0.33799999999999997,131,235,0.557,0.528,290,330,0.879,22,117,139,172,46,13,117,75,873
179,Maurice Harkless,SF,26,LAC,25,15,580,57,118,0.483,15,41,0.366,42,77,0.545,0.547,13,26,0.5,24,63,87,28,26,19,21,71,142
180,Jared Harper,PG,22,PHO,1,0,2,0,1,0.0,0,1,0.0,0,0,0.0,0.0,0,0,0.0,0,0,0,0,0,0,0,0,0
181,Montrezl Harrell,C,26,LAC,25,2,733,198,332,0.596,0,9,0.0,198,323,0.613,0.596,81,132,0.614,73,123,196,51,19,29,41,58,477
182,Gary Harris,SG,25,DEN,21,21,668,84,203,0.414,32,87,0.368,52,116,0.44799999999999995,0.493,22,29,0.759,11,54,65,39,24,7,20,45,222
183,Joe Harris,SF,28,BRK,23,23,728,126,261,0.483,66,145,0.455,60,116,0.517,0.609,22,27,0.815,20,67,87,48,17,8,31,57,340
184,Tobias Harris,PF,27,PHI,24,24,820,182,373,0.488,34,107,0.318,148,266,0.556,0.534,63,79,0.797,17,151,168,75,22,18,50,65,461
185,Shaquille Harrison,SF,26,CHI,15,4,133,18,45,0.4,3,9,0.33299999999999996,15,36,0.41700000000000004,0.433,11,18,0.611,5,22,27,19,6,4,6,16,50
186,Josh Hart,SF,24,NOP,17,4,464,64,153,0.418,37,106,0.349,27,47,0.574,0.539,26,34,0.765,18,87,105,25,17,6,21,46,191
187,Isaiah Hartenstein,C,21,HOU,8,0,96,11,15,0.733,0,1,0.0,11,14,0.7859999999999999,0.733,9,11,0.818,8,18,26,4,2,4,6,16,31
188,Udonis Haslem,PF,39,MIA,2,0,11,1,1,1.0,0,0,0.0,1,1,1.0,1.0,3,4,0.75,0,3,3,0,0,0,0,3,5
189,Jaxson Hayes,C,19,NOP,21,10,442,72,118,0.61,0,3,0.0,72,115,0.626,0.61,46,70,0.657,43,54,97,14,17,23,18,67,190
190,Gordon Hayward,SF,29,BOS,9,9,276,68,120,0.5670000000000001,13,32,0.406,55,88,0.625,0.621,16,19,0.8420000000000001,7,55,62,37,7,2,17,16,165
191,John Henson,PF,29,CLE,5,0,59,11,21,0.524,0,5,0.0,11,16,0.688,0.524,3,9,0.33299999999999996,6,8,14,5,4,6,5,5,25
192,Dewan Hernandez,C,23,TOR,3,0,9,1,5,0.2,0,1,0.0,1,4,0.25,0.2,2,2,1.0,2,5,7,0,1,0,1,5,4
193,Juan Hernangómez,PF,24,DEN,14,0,209,21,57,0.368,12,37,0.324,9,20,0.45,0.474,5,9,0.556,8,28,36,11,1,3,9,14,59
194,Willy Hernangómez,C,25,CHO,8,0,60,9,22,0.409,2,6,0.33299999999999996,7,16,0.43799999999999994,0.455,4,8,0.5,9,12,21,2,1,3,5,4,24
195,Tyler Herro,SG,20,MIA,22,3,637,117,261,0.44799999999999995,47,120,0.392,70,141,0.496,0.5379999999999999,39,47,0.83,6,83,89,44,17,3,44,32,320
196,Mario Hezonja,PF,24,POR,21,4,361,33,94,0.35100000000000003,10,31,0.32299999999999995,23,63,0.365,0.40399999999999997,21,25,0.84,13,79,92,21,12,2,19,47,97
197,Buddy Hield,SG,27,SAC,23,23,788,179,423,0.423,89,239,0.37200000000000005,90,184,0.489,0.528,46,54,0.852,22,88,110,62,19,9,59,60,493
198,George Hill,PG,33,MIL,22,0,465,72,133,0.541,33,64,0.516,39,69,0.565,0.665,31,37,0.838,22,42,64,69,17,2,18,37,208
199,Solomon Hill,SF,28,MEM,21,1,426,48,114,0.42100000000000004,24,62,0.387,24,52,0.462,0.526,11,18,0.611,11,57,68,40,23,2,19,34,131
200,Jaylen Hoard,SF,20,POR,4,0,12,1,2,0.5,0,0,0.0,1,2,0.5,0.5,1,2,0.5,1,4,5,2,1,0,0,1,3
201,Aaron Holiday,PG,23,IND,22,9,462,73,187,0.39,32,84,0.381,41,103,0.39799999999999996,0.47600000000000003,13,14,0.929,9,47,56,61,18,2,30,32,191
202,Jrue Holiday,SG,29,NOP,22,22,789,173,385,0.449,37,114,0.325,136,271,0.502,0.49700000000000005,41,61,0.672,28,82,110,146,43,15,71,56,424
203,Justin Holiday,SG,30,IND,24,2,602,63,153,0.41200000000000003,38,96,0.396,25,57,0.439,0.536,19,23,0.826,11,79,90,38,24,16,15,41,183
204,Rondae Hollis-Jefferson,SF,25,TOR,16,0,331,57,104,0.5479999999999999,1,5,0.2,56,99,0.5660000000000001,0.5529999999999999,27,37,0.73,39,47,86,23,12,6,20,28,142
205,Richaun Holmes,C,26,SAC,23,19,673,121,181,0.669,0,0,0.0,121,181,0.669,0.669,46,58,0.7929999999999999,66,132,198,24,24,32,21,93,288
206,Rodney Hood,SF,27,POR,21,21,619,87,172,0.506,35,71,0.493,52,101,0.515,0.608,21,27,0.778,10,62,72,32,17,4,19,46,230
207,Al Horford,C,33,PHI,22,22,677,124,253,0.49,33,85,0.38799999999999996,91,168,0.542,0.555,25,37,0.6759999999999999,37,111,148,87,24,23,24,52,306
208,Talen Horton-Tucker,SG,19,LAL,1,0,2,0,1,0.0,0,1,0.0,0,0,0.0,0.0,0,0,0.0,0,0,0,1,0,0,0,0,0
209,Danuel House,SF,26,HOU,17,15,507,66,145,0.455,43,101,0.426,23,44,0.523,0.603,30,37,0.8109999999999999,18,53,71,24,19,11,16,39,205
210,Dwight Howard,C,34,LAL,24,0,480,66,89,0.742,1,3,0.33299999999999996,65,86,0.7559999999999999,0.747,35,67,0.522,50,119,169,18,9,33,26,89,168
211,Kevin Huerter,SG,21,ATL,12,4,265,35,83,0.42200000000000004,20,51,0.392,15,32,0.469,0.542,12,15,0.8,7,31,38,36,9,5,17,23,102
212,De'Andre Hunter,SF,22,ATL,22,21,692,94,239,0.39299999999999996,37,105,0.35200000000000004,57,134,0.425,0.47100000000000003,41,51,0.804,11,78,89,41,14,5,39,58,266
213,Chandler Hutchison,SF,23,CHI,9,6,154,20,44,0.455,5,12,0.41700000000000004,15,32,0.469,0.511,19,29,0.655,1,32,33,8,5,2,12,12,64
214,Serge Ibaka,C,30,TOR,13,0,289,65,142,0.45799999999999996,12,32,0.375,53,110,0.48200000000000004,0.5,29,35,0.8290000000000001,23,68,91,15,6,11,29,35,171
215,Ersan İlyasova,PF,32,MIL,22,0,347,58,119,0.48700000000000004,17,54,0.315,41,65,0.631,0.5589999999999999,27,33,0.818,29,75,104,13,10,7,6,38,160
216,Joe Ingles,SF,32,UTA,24,4,668,60,164,0.366,35,108,0.324,25,56,0.446,0.473,24,32,0.75,5,92,97,97,24,2,41,55,179
217,Brandon Ingram,PF,22,NOP,20,20,674,179,362,0.494,46,110,0.418,133,252,0.528,0.5579999999999999,94,112,0.8390000000000001,15,124,139,79,16,18,58,60,498
218,Kyrie Irving,PG,27,BRK,11,11,372,112,252,0.444,31,91,0.341,81,161,0.503,0.506,59,63,0.937,10,49,59,79,12,6,26,32,314
219,Jonathan Isaac,SF,22,ORL,21,21,647,101,225,0.449,24,74,0.324,77,151,0.51,0.502,33,42,0.7859999999999999,38,115,153,30,27,60,34,49,259
220,Wesley Iwundu,SF,25,ORL,11,3,161,10,35,0.28600000000000003,1,9,0.111,9,26,0.34600000000000003,0.3,15,18,0.833,4,19,23,9,5,3,4,9,36
221,Frank Jackson,PG,21,NOP,21,1,320,52,140,0.371,20,65,0.308,32,75,0.42700000000000005,0.44299999999999995,26,32,0.813,5,25,30,22,9,1,21,32,150
222,Jaren Jackson,C,20,MEM,22,22,596,129,286,0.451,46,124,0.371,83,162,0.512,0.531,52,65,0.8,27,78,105,31,12,27,42,91,356
223,Justin Jackson,PF,24,DAL,22,0,310,54,116,0.466,23,58,0.397,31,58,0.534,0.565,10,13,0.769,9,46,55,9,5,2,4,23,141
224,Reggie Jackson,PG,29,DET,2,2,36,4,11,0.364,1,5,0.2,3,6,0.5,0.409,1,1,1.0,1,4,5,8,0,0,1,2,10
225,Justin James,SG,23,SAC,11,0,140,18,44,0.409,3,14,0.214,15,30,0.5,0.44299999999999995,1,6,0.16699999999999998,2,18,20,9,4,6,5,11,40
226,LeBron James,PG,35,LAL,24,24,825,239,477,0.501,52,143,0.364,187,334,0.56,0.556,91,129,0.705,23,141,164,259,31,13,89,42,621
227,Amile Jefferson,PF,26,ORL,5,0,13,3,3,1.0,0,0,0.0,3,3,1.0,1.0,0,0,0.0,2,2,4,2,0,0,1,2,6
228,DaQuan Jeffries,SG,22,SAC,2,0,11,1,1,1.0,0,0,0.0,1,1,1.0,1.0,0,0,0.0,1,0,1,1,0,0,0,1,2
229,Ty Jerome,PG,22,PHO,5,0,67,6,18,0.33299999999999996,3,7,0.429,3,11,0.273,0.41700000000000004,2,2,1.0,0,8,8,12,8,0,6,9,17
230,Alize Johnson,SF,23,IND,8,0,37,5,11,0.455,0,0,0.0,5,11,0.455,0.455,3,4,0.75,6,6,12,2,0,0,1,4,13
231,B.J. Johnson,SF,24,ORL,1,0,3,0,0,0.0,0,0,0.0,0,0,0.0,0.0,0,0,0.0,0,0,0,0,0,0,0,0,0
232,Cameron Johnson,PF,23,PHO,21,0,421,67,153,0.43799999999999994,42,103,0.408,25,50,0.5,0.575,16,17,0.941,21,43,64,18,12,7,14,37,192
233,James Johnson,PF,32,MIA,6,0,68,8,18,0.444,2,9,0.222,6,9,0.667,0.5,2,4,0.5,2,9,11,4,3,2,4,5,20
234,Keldon Johnson,SF,20,SAS,1,0,2,0,1,0.0,0,0,0.0,0,1,0.0,0.0,0,0,0.0,0,0,0,0,0,0,0,0,0
235,Stanley Johnson,PF,23,TOR,5,0,19,3,9,0.33299999999999996,1,4,0.25,2,5,0.4,0.389,0,0,0.0,2,5,7,0,1,0,4,6,7
236,Tyler Johnson,SG,27,PHO,19,3,364,44,111,0.396,18,55,0.327,26,56,0.46399999999999997,0.47700000000000004,18,24,0.75,5,30,35,41,6,6,19,28,124
237,Nikola Jokić,C,24,DEN,21,21,650,138,297,0.465,19,83,0.22899999999999998,119,214,0.556,0.49700000000000005,43,54,0.7959999999999999,45,167,212,128,23,12,54,68,338
238,Damian Jones,C,24,ATL,22,14,418,69,98,0.7040000000000001,2,5,0.4,67,93,0.72,0.7140000000000001,29,43,0.674,36,55,91,17,11,20,15,77,169
239,Derrick Jones,SF,22,MIA,9,0,132,16,34,0.47100000000000003,2,8,0.25,14,26,0.5379999999999999,0.5,7,10,0.7,5,15,20,7,7,2,6,18,41
240,Tyus Jones,PG,23,MEM,23,5,469,57,149,0.38299999999999995,8,37,0.21600000000000003,49,112,0.43799999999999994,0.409,18,25,0.72,0,35,35,112,20,3,30,21,140
241,DeAndre Jordan,C,31,BRK,20,3,429,67,95,0.705,0,0,0.0,67,95,0.705,0.705,29,43,0.674,45,139,184,41,8,21,21,42,163
242,Cory Joseph,PG,28,SAC,23,14,606,54,148,0.365,12,44,0.273,42,104,0.40399999999999997,0.405,16,16,1.0,12,47,59,91,20,12,30,48,136
243,Mfiondu Kabengele,C,22,LAC,8,0,35,7,18,0.389,4,10,0.4,3,8,0.375,0.5,3,3,1.0,1,5,6,1,1,1,1,3,21
244,Frank Kaminsky,C,26,PHO,23,10,541,85,199,0.42700000000000005,26,82,0.317,59,117,0.504,0.49200000000000005,45,67,0.672,24,97,121,50,9,9,24,52,241
245,Enes Kanter,C,27,BOS,15,3,239,43,73,0.589,0,1,0.0,43,72,0.597,0.589,24,37,0.649,37,50,87,17,9,6,12,19,110
246,Luke Kennard,SG,23,DET,23,20,754,128,286,0.44799999999999995,59,148,0.39899999999999997,69,138,0.5,0.551,60,67,0.8959999999999999,6,73,79,96,11,5,33,54,375
247,Stanton Kidd,SF,27,UTA,4,0,15,0,3,0.0,0,1,0.0,0,2,0.0,0.0,0,0,0.0,0,3,3,1,0,0,2,3,0
248,Michael Kidd-Gilchrist,PF,26,CHO,3,0,41,5,18,0.278,2,6,0.33299999999999996,3,12,0.25,0.33299999999999996,2,2,1.0,3,6,9,3,0,1,2,7,14
249,Maxi Kleber,C,28,DAL,22,5,534,59,140,0.42100000000000004,31,84,0.369,28,56,0.5,0.532,28,31,0.903,37,89,126,22,5,14,15,40,177
250,Brandon Knight,PG,28,CLE,8,0,95,14,40,0.35,10,31,0.32299999999999995,4,9,0.444,0.475,2,6,0.33299999999999996,1,7,8,15,4,0,6,9,40
251,Kevin Knox,SF,20,NYK,22,3,437,56,149,0.376,30,82,0.366,26,67,0.38799999999999996,0.47700000000000004,31,47,0.66,10,53,63,26,11,7,16,36,173
252,John Konchar,SG,23,MEM,1,0,7,0,0,0.0,0,0,0.0,0,0,0.0,0.0,0,0,0.0,0,0,0,0,0,0,0,0,0
253,Furkan Korkmaz,SG,22,PHI,23,11,524,71,168,0.423,38,105,0.36200000000000004,33,63,0.524,0.536,17,21,0.81,4,49,53,21,8,5,18,37,197
254,Luke Kornet,C,24,CHI,13,0,135,15,46,0.326,5,26,0.192,10,20,0.5,0.38,5,5,1.0,5,15,20,6,2,10,3,12,40
255,Kyle Korver,SF,38,MIL,20,0,308,34,94,0.36200000000000004,29,79,0.36700000000000005,5,15,0.33299999999999996,0.516,9,11,0.818,6,26,32,15,8,4,17,20,106
256,Rodions Kurucs,PF,21,BRK,10,0,99,9,23,0.391,3,7,0.429,6,16,0.375,0.457,2,6,0.33299999999999996,5,17,22,1,5,0,12,16,23
257,Kyle Kuzma,PF,24,LAL,20,1,461,81,187,0.433,32,89,0.36,49,98,0.5,0.519,27,39,0.6920000000000001,8,60,68,17,6,8,35,34,221
258,Skal Labissière,C,23,POR,24,0,398,62,108,0.574,2,8,0.25,60,100,0.6,0.583,15,22,0.682,48,73,121,26,6,24,24,61,141
259,Jeremy Lamb,SG,27,IND,15,15,485,91,193,0.47200000000000003,19,62,0.306,72,131,0.55,0.521,35,44,0.795,10,69,79,39,17,8,21,33,236
260,Romeo Langford,SG,20,BOS,1,0,0,0,0,0.0,0,0,0.0,0,0,0.0,0.0,0,0,0.0,0,0,0,0,0,0,0,0,0
261,Zach LaVine,SG,24,CHI,25,25,819,189,445,0.425,74,187,0.396,115,258,0.446,0.508,104,130,0.8,17,95,112,100,31,12,85,62,556
262,Jake Layman,PF,25,MIN,14,2,369,61,132,0.462,19,54,0.35200000000000004,42,78,0.5379999999999999,0.534,6,10,0.6,12,29,41,11,12,10,18,31,147
263,T.J. Leaf,PF,22,IND,15,1,158,26,58,0.44799999999999995,5,11,0.455,21,47,0.447,0.491,5,8,0.625,20,37,57,6,7,3,6,14,62
264,Courtney Lee,SG,34,DAL,7,3,62,13,22,0.591,7,12,0.583,6,10,0.6,0.75,0,0,0.0,0,3,3,3,0,2,1,5,33
265,Damion Lee,SG,27,GSW,11,0,241,35,91,0.385,12,35,0.34299999999999997,23,56,0.41100000000000003,0.451,28,33,0.848,9,34,43,20,8,0,13,18,110
266,Alex Len,C,26,ATL,22,9,371,66,129,0.512,5,27,0.185,61,102,0.598,0.531,30,43,0.698,31,72,103,20,11,18,21,46,167
267,Kawhi Leonard,SF,28,LAC,18,18,560,161,360,0.447,30,91,0.33,131,269,0.48700000000000004,0.489,99,116,0.853,19,123,142,94,34,14,61,36,451
268,Meyers Leonard,PF,27,MIA,23,23,425,53,91,0.5820000000000001,21,40,0.525,32,51,0.627,0.698,5,9,0.556,8,91,99,21,7,10,18,48,132
269,Caris LeVert,SG,25,BRK,9,9,284,59,140,0.42100000000000004,13,36,0.361,46,104,0.442,0.46799999999999997,20,31,0.645,10,35,45,36,6,1,31,20,151
270,Damian Lillard,PG,29,POR,22,22,812,182,411,0.44299999999999995,69,197,0.35,113,214,0.528,0.527,154,169,0.9109999999999999,11,91,102,163,23,10,63,45,587
271,Nassir Little,PF,19,POR,17,3,259,29,71,0.408,5,29,0.172,24,42,0.5710000000000001,0.444,13,20,0.65,19,41,60,8,7,7,9,34,76
272,Kevon Looney,C,23,GSW,5,2,56,6,18,0.33299999999999996,1,1,1.0,5,17,0.294,0.361,2,4,0.5,9,9,18,2,1,2,4,9,15
273,Brook Lopez,C,31,MIL,22,22,580,75,190,0.395,32,109,0.294,43,81,0.531,0.479,41,44,0.932,12,94,106,30,16,52,22,47,223
274,Robin Lopez,C,31,MIL,24,2,346,48,102,0.47100000000000003,13,42,0.31,35,60,0.583,0.534,10,17,0.588,26,40,66,17,4,16,29,42,119
275,Kevin Love,PF,31,CLE,19,19,574,91,212,0.429,40,112,0.35700000000000004,51,100,0.51,0.524,75,85,0.882,18,181,199,50,12,7,52,26,297
276,Kyle Lowry,PG,33,TOR,12,12,448,71,168,0.423,37,100,0.37,34,68,0.5,0.5329999999999999,63,70,0.9,7,51,58,83,13,5,38,35,242
277,Timothé Luwawu-Cabarrot,SG,24,BRK,2,0,6,0,2,0.0,0,1,0.0,0,1,0.0,0.0,1,2,0.5,0,0,0,0,0,0,0,0,1
278,Trey Lyles,PF,24,SAS,23,14,397,38,88,0.43200000000000005,18,48,0.375,20,40,0.5,0.534,5,9,0.556,32,108,140,29,7,7,18,27,99
279,Daryl Macon,SG,24,MIA,3,0,13,1,3,0.33299999999999996,1,2,0.5,0,1,0.0,0.5,0,0,0.0,0,0,0,1,0,0,2,1,3
280,Josh Magette,PG,30,ORL,3,0,10,2,6,0.33299999999999996,0,0,0.0,2,6,0.33299999999999996,0.33299999999999996,1,2,0.5,1,2,3,2,2,0,3,0,5
281,Ian Mahinmi,C,33,WAS,2,0,31,6,9,0.667,0,0,0.0,6,9,0.667,0.667,4,6,0.667,5,6,11,2,0,3,3,7,16
282,Thon Maker,C,22,DET,22,0,230,23,43,0.535,7,14,0.5,16,29,0.552,0.616,16,31,0.516,10,27,37,9,6,14,11,31,69
283,Terance Mann,SG,23,LAC,19,3,166,19,39,0.48700000000000004,2,9,0.222,17,30,0.5670000000000001,0.513,7,8,0.875,3,19,22,22,6,2,12,21,47
284,Boban Marjanović,C,31,DAL,10,1,131,31,56,0.5539999999999999,0,1,0.0,31,55,0.564,0.5539999999999999,13,16,0.813,15,40,55,7,2,3,9,18,75
285,Lauri Markkanen,PF,22,CHI,25,25,754,112,296,0.37799999999999995,49,153,0.32,63,143,0.441,0.461,82,101,0.812,25,145,170,41,22,12,48,48,355
286,Caleb Martin,SF,24,CHO,4,0,28,3,10,0.3,0,3,0.0,3,7,0.429,0.3,1,3,0.33299999999999996,1,4,5,3,1,2,3,3,7
287,Cody Martin,SF,24,CHO,17,0,192,16,43,0.37200000000000005,1,18,0.055999999999999994,15,25,0.6,0.384,15,22,0.682,8,28,36,18,13,1,7,19,48
288,Kelan Martin,SF,24,MIN,9,0,123,15,44,0.341,5,24,0.20800000000000002,10,20,0.5,0.39799999999999996,0,0,0.0,2,24,26,3,1,1,4,20,35
289,Frank Mason,PG,25,MIL,2,0,10,1,4,0.25,1,2,0.5,0,2,0.0,0.375,1,2,0.5,0,0,0,2,0,0,0,1,4
290,Garrison Mathews,SG,23,WAS,2,0,14,0,2,0.0,0,2,0.0,0,0,0.0,0.0,0,0,0.0,0,1,1,2,0,0,1,3,0
291,Wesley Matthews,SG,33,MIL,24,24,578,67,152,0.441,40,104,0.385,27,48,0.563,0.5720000000000001,23,27,0.852,4,51,55,36,13,2,19,29,197
292,Patrick McCaw,SF,24,TOR,2,0,40,3,5,0.6,1,3,0.33299999999999996,2,2,1.0,0.7,1,2,0.5,2,4,6,3,3,0,3,3,8
293,CJ McCollum,SG,28,POR,24,24,874,212,474,0.447,63,163,0.387,149,311,0.479,0.514,41,51,0.804,20,87,107,90,19,21,46,68,528
294,T.J. McConnell,PG,27,IND,22,0,383,65,135,0.48100000000000004,1,4,0.25,64,131,0.489,0.485,10,11,0.909,10,49,59,106,11,4,32,27,141
295,Jalen McDaniels,PF,22,CHO,1,0,3,1,2,0.5,0,0,0.0,1,2,0.5,0.5,0,0,0.0,1,0,1,0,0,0,0,0,2
296,Doug McDermott,PF,28,IND,24,0,498,85,183,0.46399999999999997,44,94,0.46799999999999997,41,89,0.461,0.585,13,15,0.867,10,56,66,28,3,3,20,47,227
297,JaVale McGee,C,32,LAL,24,24,396,78,126,0.619,0,0,0.0,78,126,0.619,0.619,17,26,0.654,46,101,147,15,14,28,18,54,173
298,Rodney McGruder,SG,28,LAC,15,2,260,23,60,0.38299999999999995,11,35,0.314,12,25,0.48,0.475,3,8,0.375,11,25,36,12,4,3,7,26,60
299,Alfonzo McKinnie,SF,27,CLE,17,0,175,17,50,0.34,8,25,0.32,9,25,0.36,0.42,7,11,0.636,10,26,36,3,6,3,8,20,49
300,Jordan McLaughlin,PG,23,MIN,4,0,57,4,15,0.267,1,8,0.125,3,7,0.429,0.3,2,2,1.0,1,6,7,8,1,0,4,4,11
301,Ben McLemore,SG,26,HOU,23,7,516,76,189,0.402,56,161,0.348,20,28,0.7140000000000001,0.55,25,29,0.862,9,47,56,24,15,6,19,47,233
302,Jordan McRae,SG,28,WAS,13,0,235,43,91,0.473,13,33,0.39399999999999996,30,58,0.517,0.544,17,19,0.895,3,28,31,36,8,4,14,26,116
303,Nicolò Melli,C,29,NOP,22,3,341,41,99,0.414,22,67,0.32799999999999996,19,32,0.594,0.525,19,24,0.792,14,45,59,24,14,4,17,42,123
304,De'Anthony Melton,PG,21,MEM,12,0,171,24,59,0.40700000000000003,5,17,0.294,19,42,0.452,0.449,14,16,0.875,8,28,36,34,15,2,17,16,67
305,Chimezie Metu,PF,22,SAS,6,0,21,7,12,0.583,0,0,0.0,7,12,0.583,0.583,2,4,0.5,7,4,11,2,0,2,0,0,16
306,Khris Middleton,SF,28,MIL,17,14,464,110,225,0.489,36,90,0.4,74,135,0.5479999999999999,0.569,42,47,0.894,13,85,98,57,14,2,30,42,298
307,C.J. Miles,SG,32,WAS,10,0,161,19,59,0.322,11,35,0.314,8,24,0.33299999999999996,0.415,15,20,0.75,4,8,12,12,10,4,4,14,64
308,Malcolm Miller,SF,26,TOR,9,1,54,6,12,0.5,5,10,0.5,1,2,0.5,0.708,1,6,0.16699999999999998,0,7,7,4,0,2,2,6,18
309,Patty Mills,PG,31,SAS,23,1,538,90,196,0.45899999999999996,47,113,0.41600000000000004,43,83,0.518,0.579,29,37,0.784,4,28,32,53,21,4,24,35,256
310,Paul Millsap,PF,34,DEN,21,21,537,93,195,0.47700000000000004,25,52,0.48100000000000004,68,143,0.47600000000000003,0.541,63,72,0.875,41,82,123,28,17,17,26,59,274
311,Shake Milton,SG,23,PHI,9,0,82,12,35,0.34299999999999997,4,19,0.21100000000000002,8,16,0.5,0.4,7,9,0.778,1,7,8,7,1,0,12,13,35
312,Donovan Mitchell,SG,23,UTA,24,24,830,217,496,0.43799999999999994,54,149,0.36200000000000004,163,347,0.47,0.49200000000000005,104,124,0.8390000000000001,21,93,114,86,30,6,57,53,592
313,Naz Mitrou-Long,SG,26,IND,3,0,43,6,16,0.375,2,11,0.182,4,5,0.8,0.43799999999999994,0,0,0.0,0,6,6,7,1,1,2,1,14
314,Malik Monk,SG,21,CHO,25,0,516,89,202,0.441,25,95,0.263,64,107,0.598,0.502,30,36,0.833,7,58,65,54,10,6,36,42,233
315,E'Twaun Moore,SG,30,NOP,16,3,326,59,140,0.42100000000000004,21,55,0.382,38,85,0.447,0.496,14,22,0.636,13,38,51,23,8,1,11,27,153
316,Ja Morant,PG,20,MEM,18,18,518,126,272,0.46299999999999997,19,44,0.43200000000000005,107,228,0.469,0.498,72,93,0.774,16,40,56,116,24,5,60,30,343
317,Juwan Morgan,PF,22,UTA,3,0,9,0,0,0.0,0,0,0.0,0,0,0.0,0.0,0,0,0.0,0,2,2,0,0,0,1,1,0
318,Marcus Morris,SF,30,NYK,21,21,687,127,299,0.425,60,120,0.5,67,179,0.374,0.525,76,90,0.8440000000000001,23,99,122,27,19,13,37,66,390
319,Markieff Morris,PF,30,DET,23,12,507,86,186,0.462,35,88,0.39799999999999996,51,98,0.52,0.556,26,34,0.765,12,77,89,35,15,4,38,54,233
320,Monte Morris,PG,24,DEN,21,0,361,59,137,0.431,11,28,0.39299999999999996,48,109,0.44,0.47100000000000003,22,30,0.733,4,31,35,71,10,5,15,19,151
321,Johnathan Motley,PF,24,LAC,2,0,4,1,3,0.33299999999999996,1,1,1.0,0,2,0.0,0.5,0,0,0.0,1,1,2,2,0,0,2,1,3
322,Emmanuel Mudiay,PG,23,UTA,21,0,330,59,127,0.465,9,31,0.29,50,96,0.521,0.5,22,27,0.815,6,46,52,50,6,4,37,35,149
323,Dejounte Murray,PG,23,SAS,20,13,452,76,168,0.452,5,26,0.192,71,142,0.5,0.467,37,47,0.787,25,96,121,81,32,5,45,46,194
324,Jamal Murray,PG,22,DEN,21,21,688,145,332,0.43700000000000006,36,106,0.34,109,226,0.48200000000000004,0.491,56,62,0.903,17,74,91,100,32,8,48,38,382
325,Džanan Musa,SF,20,BRK,18,0,278,29,90,0.322,8,44,0.182,21,46,0.457,0.36700000000000005,22,29,0.759,8,39,47,24,8,1,22,16,88
326,Mike Muscala,C,28,OKC,15,0,166,18,58,0.31,12,44,0.273,6,14,0.429,0.414,7,8,0.875,6,29,35,14,4,3,6,20,55
327,Sviatoslav Mykhailiuk,SF,22,DET,19,1,324,37,86,0.43,29,63,0.46,8,23,0.348,0.599,5,6,0.833,4,19,23,25,8,1,17,22,108
328,Abdel Nader,SF,26,OKC,16,3,263,38,79,0.48100000000000004,16,39,0.41,22,40,0.55,0.5820000000000001,20,24,0.833,5,25,30,9,5,6,16,24,112
329,Larry Nance,C,27,CLE,21,4,545,79,157,0.503,25,67,0.373,54,90,0.6,0.583,25,35,0.7140000000000001,41,113,154,31,19,10,22,35,208
330,Shabazz Napier,PG,28,MIN,11,0,198,27,70,0.386,11,44,0.25,16,26,0.615,0.46399999999999997,21,24,0.875,1,22,23,36,12,3,20,11,86
331,Raul Neto,PG,27,PHI,21,2,258,39,77,0.506,14,28,0.5,25,49,0.51,0.597,3,4,0.75,3,20,23,34,9,2,18,13,95
332,Georges Niang,PF,26,UTA,18,0,207,28,61,0.45899999999999996,14,37,0.37799999999999995,14,24,0.583,0.574,7,10,0.7,2,29,31,9,1,2,10,27,77
333,Nerlens Noel,C,25,OKC,22,3,408,66,102,0.647,0,0,0.0,66,102,0.647,0.647,34,43,0.7909999999999999,31,80,111,34,21,35,23,61,166
334,Zach Norvell,SG,22,LAL,2,0,5,0,1,0.0,0,0,0.0,0,1,0.0,0.0,0,0,0.0,0,1,1,0,0,0,0,0,0
335,Jaylen Nowell,SG,20,MIN,2,0,15,1,4,0.25,0,3,0.0,1,1,1.0,0.25,1,1,1.0,0,1,1,3,0,0,1,1,3
336,Frank Ntilikina,PG,21,NYK,21,17,538,51,133,0.38299999999999995,19,54,0.35200000000000004,32,79,0.405,0.455,13,17,0.765,8,37,45,71,27,10,24,55,134
337,Kendrick Nunn,SG,24,MIA,23,23,689,140,315,0.444,47,135,0.348,93,180,0.517,0.519,26,33,0.7879999999999999,7,51,58,78,24,7,49,59,353
338,David Nwaba,SF,27,BRK,15,0,184,24,43,0.5579999999999999,7,16,0.43799999999999994,17,27,0.63,0.64,9,16,0.563,7,24,31,5,5,9,6,23,64
339,Royce O'Neale,PF,26,UTA,24,22,680,49,105,0.467,29,65,0.446,20,40,0.5,0.605,12,14,0.857,3,108,111,62,19,6,21,72,139
340,Kyle O'Quinn,C,29,PHI,14,0,147,23,43,0.535,5,13,0.385,18,30,0.6,0.593,2,6,0.33299999999999996,16,38,54,20,2,11,15,22,53
341,Semi Ojeleye,PF,25,BOS,22,1,325,22,52,0.423,12,32,0.375,10,20,0.5,0.5379999999999999,7,10,0.7,7,35,42,8,10,1,5,27,63
342,Jahlil Okafor,C,24,NOP,15,7,274,55,87,0.632,1,2,0.5,54,85,0.635,0.638,27,39,0.6920000000000001,25,45,70,21,5,15,25,45,138
343,Elie Okobo,PG,22,PHO,16,0,152,21,52,0.40399999999999997,10,25,0.4,11,27,0.40700000000000003,0.5,11,21,0.524,2,13,15,38,4,0,4,8,63
344,Josh Okogie,SG,21,MIN,21,6,523,59,134,0.44,16,51,0.314,43,83,0.518,0.5,55,70,0.7859999999999999,31,75,106,34,22,7,31,48,189
345,KZ Okpala,SF,20,MIA,2,0,3,0,0,0.0,0,0,0.0,0,0,0.0,0.0,0,0,0.0,0,1,1,0,0,0,1,0,0
346,Kelly Olynyk,C,28,MIA,23,0,538,70,151,0.46399999999999997,38,89,0.42700000000000005,32,62,0.516,0.589,29,33,0.879,22,91,113,31,22,9,32,63,207
347,Miye Oni,SG,22,UTA,3,0,8,0,0,0.0,0,0,0.0,0,0,0.0,0.0,0,0,0.0,0,1,1,0,0,0,1,0,0
348,Cedi Osman,SF,24,CLE,23,23,672,79,187,0.42200000000000004,36,99,0.364,43,88,0.489,0.519,21,32,0.6559999999999999,9,69,78,47,25,6,29,52,215
349,Kelly Oubre,SF,24,PHO,23,23,740,141,316,0.446,35,107,0.327,106,209,0.507,0.502,86,110,0.782,32,105,137,34,31,17,37,76,403
350,Jabari Parker,PF,24,ATL,23,18,644,153,305,0.502,24,87,0.276,129,218,0.5920000000000001,0.541,42,58,0.7240000000000001,42,104,146,43,34,12,45,73,372
351,Chandler Parsons,SF,31,ATL,3,0,35,4,12,0.33299999999999996,3,10,0.3,1,2,0.5,0.45799999999999996,0,0,0.0,1,3,4,2,4,0,1,3,11
352,Eric Paschall,PF,23,GSW,24,18,755,147,296,0.49700000000000005,17,58,0.293,130,238,0.546,0.525,87,107,0.813,35,90,125,41,9,9,40,47,398
353,Patrick Patterson,PF,30,LAC,22,12,307,36,93,0.387,30,73,0.41100000000000003,6,20,0.3,0.5479999999999999,8,12,0.667,14,46,60,17,4,2,7,19,110
354,Justin Patton,C,22,OKC,2,0,9,1,3,0.33299999999999996,0,1,0.0,1,2,0.5,0.33299999999999996,0,0,0.0,0,2,2,0,0,0,1,4,2
355,Chris Paul,PG,34,OKC,23,23,712,121,267,0.45299999999999996,35,98,0.35700000000000004,86,169,0.509,0.519,91,102,0.892,6,89,95,135,38,2,39,55,368
356,Elfrid Payton,PG,25,NYK,6,3,130,16,41,0.39,6,10,0.6,10,31,0.32299999999999995,0.46299999999999997,7,8,0.875,5,12,17,24,13,1,12,10,45
357,Norvel Pelle,SF,26,PHI,2,0,25,2,3,0.667,0,0,0.0,2,3,0.667,0.667,4,6,0.667,2,8,10,2,0,4,2,4,8
358,Theo Pinson,SG,24,BRK,14,0,209,24,89,0.27,8,42,0.19,16,47,0.34,0.315,11,12,0.917,7,24,31,32,8,0,20,21,67
359,Mason Plumlee,C,29,DEN,21,0,350,59,100,0.59,0,4,0.0,59,96,0.615,0.59,27,51,0.529,37,84,121,48,15,17,32,54,145
360,Vincent Poirier,C,26,BOS,9,0,44,7,14,0.5,0,0,0.0,7,14,0.5,0.5,1,2,0.5,8,7,15,3,2,2,3,10,15
361,Jakob Pöltl,C,24,SAS,23,7,435,60,101,0.594,0,0,0.0,60,101,0.594,0.594,19,34,0.5589999999999999,53,86,139,35,14,31,21,42,139
362,Shamorie Ponds,PG,21,TOR,2,0,8,2,4,0.5,0,1,0.0,2,3,0.667,0.5,0,0,0.0,0,1,1,2,0,1,0,2,4
363,Jordan Poole,SG,20,GSW,24,9,576,59,229,0.258,29,118,0.24600000000000002,30,111,0.27,0.321,42,49,0.857,4,50,54,49,15,6,29,44,189
364,Kevin Porter,SF,19,CLE,22,1,460,59,143,0.413,13,50,0.26,46,93,0.495,0.45799999999999996,22,30,0.733,8,63,71,42,19,5,35,54,153
365,Michael Porter,PF,21,DEN,12,0,103,21,45,0.467,5,15,0.33299999999999996,16,30,0.5329999999999999,0.522,5,8,0.625,10,19,29,5,0,3,8,14,52
366,Otto Porter,SF,26,CHI,9,9,226,35,84,0.41700000000000004,16,40,0.4,19,44,0.43200000000000005,0.512,15,20,0.75,8,23,31,14,9,3,7,20,101
367,Bobby Portis,C,24,NYK,23,2,502,79,198,0.39899999999999997,23,65,0.354,56,133,0.42100000000000004,0.457,18,25,0.72,36,96,132,25,15,8,21,40,199
368,Kristaps Porziņģis,PF,24,DAL,22,22,665,129,324,0.39799999999999996,44,130,0.33799999999999997,85,194,0.43799999999999994,0.466,59,84,0.7020000000000001,37,154,191,30,12,44,35,64,361
369,Dwight Powell,C,28,DAL,20,17,506,67,98,0.684,6,13,0.462,61,85,0.718,0.7140000000000001,23,41,0.561,31,62,93,25,16,8,19,51,163
370,Norman Powell,SG,26,TOR,23,12,644,110,236,0.466,39,109,0.358,71,127,0.5589999999999999,0.5489999999999999,47,58,0.81,12,77,89,36,24,8,35,41,306
371,Julius Randle,PF,25,NYK,23,23,738,140,321,0.436,19,80,0.23800000000000002,121,241,0.502,0.466,86,130,0.662,56,142,198,79,17,3,74,65,385
372,Cam Reddish,SF,20,ATL,20,17,496,56,176,0.318,19,76,0.25,37,100,0.37,0.37200000000000005,28,37,0.757,13,60,73,32,19,7,35,35,159
373,J.J. Redick,SG,35,NOP,23,19,653,106,247,0.429,75,167,0.449,31,80,0.38799999999999996,0.581,58,67,0.866,4,68,72,47,10,5,30,38,345
374,Naz Reid,C,20,MIN,2,0,4,1,2,0.5,1,2,0.5,0,0,0.0,0.75,0,0,0.0,0,1,1,0,0,0,0,1,3
375,Josh Richardson,SG,26,PHI,16,16,512,93,204,0.456,32,83,0.386,61,121,0.504,0.534,40,50,0.8,10,45,55,58,18,10,37,47,258
376,Austin Rivers,SG,27,HOU,22,1,547,67,162,0.414,31,95,0.326,36,67,0.537,0.509,20,28,0.7140000000000001,17,43,60,34,11,4,15,44,185
377,Duncan Robinson,SF,25,MIA,23,18,598,85,185,0.45899999999999996,65,153,0.425,20,32,0.625,0.635,15,16,0.938,3,65,68,17,19,8,16,61,250
378,Glenn Robinson,SF,26,GSW,25,25,802,115,253,0.455,30,79,0.38,85,174,0.489,0.514,27,32,0.8440000000000001,36,82,118,43,25,7,22,41,287
379,Jerome Robinson,SG,22,LAC,20,0,256,29,87,0.33299999999999996,11,40,0.275,18,47,0.38299999999999995,0.397,5,10,0.5,2,32,34,19,7,7,15,28,74
380,Justin Robinson,PG,22,WAS,5,0,14,2,5,0.4,1,1,1.0,1,4,0.25,0.5,0,0,0.0,1,2,3,2,0,0,2,0,5
381,Mitchell Robinson,C,21,NYK,19,6,403,69,101,0.6829999999999999,0,0,0.0,69,101,0.6829999999999999,0.6829999999999999,37,59,0.627,55,72,127,12,14,37,16,65,175
382,Rajon Rondo,PG,33,LAL,13,0,272,42,91,0.462,19,36,0.528,23,55,0.418,0.5660000000000001,8,11,0.727,4,42,46,76,14,1,24,13,111
383,Derrick Rose,PG,31,DET,19,1,451,122,250,0.488,14,43,0.326,108,207,0.522,0.516,47,54,0.87,9,30,39,110,15,8,47,21,305
384,Terrence Ross,SG,28,ORL,21,0,513,99,236,0.419,43,131,0.32799999999999996,56,105,0.5329999999999999,0.511,42,50,0.84,6,56,62,21,19,6,25,37,283
385,Terry Rozier,PG,25,CHO,25,25,818,155,357,0.434,69,167,0.413,86,190,0.45299999999999996,0.531,59,68,0.868,19,91,110,105,30,4,71,56,438
386,Ricky Rubio,PG,29,PHO,18,18,569,81,211,0.384,20,64,0.313,61,147,0.415,0.431,46,56,0.821,13,73,86,166,24,3,34,48,228
387,D'Angelo Russell,SG,23,GSW,13,13,402,100,231,0.433,37,105,0.35200000000000004,63,126,0.5,0.513,49,66,0.742,4,44,48,81,9,5,43,22,286
388,Domantas Sabonis,C,23,IND,22,22,758,160,313,0.511,5,26,0.192,155,287,0.54,0.519,79,102,0.775,79,218,297,82,17,13,61,81,404
389,JaKarr Sampson,SF,26,IND,9,7,166,23,41,0.561,2,10,0.2,21,31,0.677,0.585,2,7,0.28600000000000003,7,17,24,4,5,6,6,23,50
390,Dario Šarić,PF,25,PHO,23,23,648,93,214,0.435,38,110,0.345,55,104,0.529,0.523,35,41,0.8540000000000001,43,124,167,47,20,10,31,61,259
391,Tomáš Satoranský,PG,28,CHI,25,25,684,85,193,0.44,29,75,0.387,56,118,0.475,0.516,37,42,0.8809999999999999,21,62,83,136,37,3,51,51,236
392,Admiral Schofield,SF,22,WAS,9,0,76,7,12,0.583,4,9,0.444,3,3,1.0,0.75,4,4,1.0,2,9,11,1,0,0,3,7,22
393,Dennis Schröder,PG,26,OKC,23,0,675,150,327,0.45899999999999996,35,108,0.324,115,219,0.525,0.512,50,62,0.8059999999999999,8,78,86,81,16,7,60,52,385
394,Mike Scott,PF,31,PHI,24,1,451,54,125,0.43200000000000005,27,78,0.34600000000000003,27,47,0.574,0.54,12,15,0.8,18,63,81,18,7,2,10,38,147
395,Thabo Sefolosha,PF,35,HOU,19,0,201,16,46,0.348,8,28,0.28600000000000003,8,18,0.444,0.435,0,1,0.0,11,34,45,15,9,4,6,19,40
396,Collin Sexton,SG,21,CLE,23,23,699,153,356,0.43,25,80,0.313,128,276,0.46399999999999997,0.465,67,83,0.807,23,49,72,55,20,1,42,45,398
397,Landry Shamet,SG,22,LAC,10,10,294,30,77,0.39,21,58,0.36200000000000004,9,19,0.474,0.526,10,10,1.0,0,15,15,17,4,1,12,31,91
398,Iman Shumpert,SG,29,BRK,12,0,226,20,59,0.33899999999999997,7,31,0.226,13,28,0.46399999999999997,0.39799999999999996,3,5,0.6,9,23,32,12,12,2,10,20,50
399,Pascal Siakam,PF,25,TOR,23,23,849,211,461,0.45799999999999996,52,143,0.364,159,318,0.5,0.514,90,111,0.8109999999999999,36,158,194,82,21,16,63,62,564
400,Chris Silva,PF,23,MIA,21,0,208,29,44,0.659,0,2,0.0,29,42,0.69,0.659,24,34,0.706,40,44,84,13,5,14,25,56,82
401,Ben Simmons,PG,23,PHI,22,22,753,131,229,0.5720000000000001,2,4,0.5,129,225,0.573,0.5760000000000001,50,85,0.588,34,117,151,186,51,12,84,73,314
402,Anfernee Simons,SG,20,POR,24,1,514,89,212,0.42,34,100,0.34,55,112,0.491,0.5,29,39,0.7440000000000001,7,38,45,36,11,3,24,48,241
403,Marcus Smart,SG,25,BOS,20,15,635,82,212,0.387,42,126,0.33299999999999996,40,86,0.465,0.486,29,33,0.879,19,48,67,91,26,9,25,46,235
404,Dennis Smith,PG,22,NYK,16,1,279,32,100,0.32,9,31,0.29,23,69,0.33299999999999996,0.365,14,25,0.56,11,18,29,46,7,5,26,36,87
405,Ish Smith,PG,31,WAS,22,8,543,84,187,0.449,20,54,0.37,64,133,0.48100000000000004,0.503,12,18,0.667,11,54,65,95,16,7,27,37,200
406,Tony Snell,SF,28,DET,20,18,508,56,120,0.467,38,85,0.447,18,35,0.514,0.625,4,4,1.0,5,31,36,29,8,2,10,37,154
407,Omari Spellman,PF,22,GSW,24,0,436,67,152,0.441,19,50,0.38,48,102,0.47100000000000003,0.503,36,43,0.8370000000000001,52,79,131,24,16,16,34,27,189
408,Max Strus,SG,23,CHI,2,0,6,2,3,0.667,0,1,0.0,2,2,1.0,0.667,1,1,1.0,1,0,1,0,0,0,0,1,5
409,Edmond Sumner,PG,24,IND,4,2,72,9,19,0.474,0,3,0.0,9,16,0.563,0.474,3,5,0.6,1,2,3,8,5,1,1,9,21
410,Caleb Swanigan,PF,22,SAC,4,0,11,1,2,0.5,0,0,0.0,1,2,0.5,0.5,1,2,0.5,1,3,4,0,1,2,3,3,3
411,Jayson Tatum,PF,21,BOS,22,22,750,168,405,0.415,55,149,0.369,113,256,0.441,0.483,73,89,0.82,27,131,158,62,32,17,49,49,464
412,Jeff Teague,PG,31,MIN,19,12,554,79,182,0.434,17,49,0.34700000000000003,62,133,0.466,0.48100000000000004,74,86,0.86,10,41,51,132,18,5,44,41,249
413,Garrett Temple,SG,33,BRK,23,14,638,83,200,0.415,51,141,0.36200000000000004,32,59,0.542,0.5429999999999999,19,25,0.76,12,62,74,53,22,13,25,46,236
414,Daniel Theis,C,27,BOS,19,18,409,51,98,0.52,5,17,0.294,46,81,0.568,0.546,21,31,0.677,29,92,121,26,9,31,17,57,128
415,Isaiah Thomas,PG,30,WAS,17,14,424,82,184,0.446,34,83,0.41,48,101,0.475,0.5379999999999999,16,20,0.8,3,28,31,86,8,4,37,37,214
416,Khyri Thomas,SG,23,DET,2,0,6,0,0,0.0,0,0,0.0,0,0,0.0,0.0,1,2,0.5,0,0,0,0,0,0,0,0,1
417,Matt Thomas,SG,25,TOR,12,0,136,20,37,0.541,14,26,0.5379999999999999,6,11,0.545,0.73,3,5,0.6,1,12,13,4,4,0,4,12,57
418,Tristan Thompson,C,28,CLE,22,22,687,129,248,0.52,3,7,0.429,126,241,0.523,0.526,42,74,0.568,91,131,222,52,19,25,36,56,303
419,Matisse Thybulle,SG,22,PHI,23,3,383,36,84,0.429,22,50,0.44,14,34,0.41200000000000003,0.56,15,20,0.75,5,19,24,30,34,17,24,54,109
420,Anthony Tolliver,PF,34,POR,17,7,280,17,58,0.293,13,46,0.28300000000000003,4,12,0.33299999999999996,0.405,9,11,0.818,10,43,53,11,4,6,11,23,56
421,Karl-Anthony Towns,C,24,MIN,21,21,708,189,366,0.516,75,177,0.424,114,189,0.603,0.619,96,120,0.8,55,191,246,95,21,29,62,71,549
422,Gary Trent,SG,21,POR,11,1,93,15,33,0.455,11,23,0.478,4,10,0.4,0.621,0,0,0.0,3,9,12,5,2,2,2,7,41
423,Allonzo Trier,PG,24,NYK,11,1,142,24,46,0.522,12,27,0.444,12,19,0.632,0.652,23,28,0.821,1,16,17,14,2,3,16,22,83
424,P.J. Tucker,PF,34,HOU,23,23,824,82,161,0.509,45,104,0.433,37,57,0.649,0.649,16,20,0.8,36,128,164,33,30,12,23,78,225
425,Evan Turner,PG,31,ATL,14,0,195,23,58,0.397,0,4,0.0,23,54,0.426,0.397,12,14,0.857,7,22,29,32,8,8,20,16,58
426,Myles Turner,C,23,IND,16,16,491,63,150,0.42,23,64,0.359,40,86,0.465,0.49700000000000005,25,34,0.735,25,65,90,19,11,38,27,40,174
427,Jonas Valančiūnas,C,27,MEM,21,21,521,125,215,0.581,12,32,0.375,113,183,0.617,0.609,37,48,0.7709999999999999,54,152,206,41,8,18,48,61,299
428,Denzel Valentine,SF,26,CHI,11,0,121,27,58,0.466,18,40,0.45,9,18,0.5,0.621,0,0,0.0,2,19,21,11,4,2,3,13,72
429,Jarred Vanderbilt,SF,20,DEN,3,0,9,0,0,0.0,0,0,0.0,0,0,0.0,0.0,0,0,0.0,0,2,2,1,0,0,1,0,0
430,Fred VanVleet,PG,25,TOR,22,22,806,126,308,0.409,58,147,0.395,68,161,0.42200000000000004,0.503,85,97,0.8759999999999999,4,79,83,155,44,3,52,51,395
431,Noah Vonleh,C,24,MIN,16,1,181,20,43,0.465,1,10,0.1,19,33,0.5760000000000001,0.47700000000000004,16,19,0.8420000000000001,18,36,54,16,4,3,13,20,57
432,Nikola Vučević,C,29,ORL,14,14,431,95,211,0.45,16,50,0.32,79,161,0.491,0.488,33,39,0.846,41,121,162,49,9,15,20,27,239
433,Dean Wade,PF,23,CLE,3,0,18,1,2,0.5,1,1,1.0,0,1,0.0,0.75,0,0,0.0,0,2,2,0,1,0,0,3,3
434,Moritz Wagner,C,22,WAS,20,3,403,90,153,0.588,22,54,0.40700000000000003,68,99,0.687,0.66,33,40,0.825,31,90,121,25,15,12,43,77,235
435,Kemba Walker,PG,29,BOS,21,21,671,150,357,0.42,75,186,0.40299999999999997,75,171,0.439,0.525,83,91,0.912,21,72,93,107,20,12,46,36,458
436,Lonnie Walker,SG,21,SAS,16,0,128,27,62,0.435,6,16,0.375,21,46,0.457,0.484,5,13,0.385,6,15,21,8,4,2,7,11,65
437,Tyrone Wallace,SG,25,ATL,14,0,160,14,44,0.318,1,15,0.067,13,29,0.44799999999999995,0.33,11,17,0.647,3,19,22,13,7,1,10,19,40
438,Taurean Waller-Prince,SF,25,BRK,23,23,701,111,272,0.408,63,158,0.39899999999999997,48,114,0.42100000000000004,0.524,23,31,0.742,19,123,142,51,20,9,48,61,308
439,Derrick Walton,PG,24,LAC,9,0,64,6,12,0.5,3,8,0.375,3,4,0.75,0.625,3,3,1.0,2,2,4,5,2,0,1,6,18
440,Brad Wanamaker,PG,30,BOS,22,0,391,52,111,0.46799999999999997,11,29,0.379,41,82,0.5,0.518,45,51,0.882,9,34,43,63,16,5,26,37,160
441,T.J. Warren,SF,26,IND,24,24,792,177,348,0.509,30,76,0.395,147,272,0.54,0.552,58,70,0.8290000000000001,17,67,84,24,26,7,33,68,442
442,PJ Washington,PF,21,CHO,25,25,708,112,228,0.491,34,80,0.425,78,148,0.527,0.5660000000000001,44,63,0.698,23,104,127,44,27,21,31,68,302
443,Yuta Watanabe,SG,25,MEM,3,0,11,3,5,0.6,1,1,1.0,2,4,0.5,0.7,0,0,0.0,0,2,2,0,0,1,0,1,7
444,Tremont Waters,PG,22,BOS,1,0,20,2,7,0.28600000000000003,1,5,0.2,1,2,0.5,0.35700000000000004,2,2,1.0,0,2,2,3,1,2,2,2,7
445,Russell Westbrook,PG,31,HOU,21,21,723,175,416,0.42100000000000004,25,109,0.22899999999999998,150,307,0.489,0.451,96,129,0.7440000000000001,34,136,170,157,34,8,96,83,471
446,Coby White,SG,19,CHI,25,0,632,107,299,0.358,51,149,0.342,56,150,0.373,0.44299999999999995,33,42,0.7859999999999999,7,86,93,61,17,0,37,36,298
447,Derrick White,SG,25,SAS,21,9,501,71,157,0.452,20,51,0.392,51,106,0.48100000000000004,0.516,41,52,0.7879999999999999,11,37,48,61,9,15,26,50,203
448,Hassan Whiteside,C,30,POR,21,21,593,132,217,0.608,0,0,0.0,132,217,0.608,0.608,58,77,0.753,77,183,260,28,10,47,42,62,322
449,Andrew Wiggins,SF,24,MIN,19,19,658,174,384,0.45299999999999996,41,123,0.33299999999999996,133,261,0.51,0.507,76,105,0.7240000000000001,23,75,98,64,11,24,37,46,465
450,Grant Williams,PF,21,BOS,21,1,301,15,60,0.25,1,26,0.038,14,34,0.41200000000000003,0.258,14,17,0.8240000000000001,15,30,45,18,8,12,16,39,45
451,Kenrich Williams,PF,25,NOP,22,12,554,44,107,0.41100000000000003,21,68,0.309,23,39,0.59,0.509,9,22,0.409,36,93,129,37,20,16,17,57,118
452,Lou Williams,SG,33,LAC,25,3,774,163,401,0.406,42,122,0.344,121,279,0.434,0.45899999999999996,132,155,0.852,12,66,78,154,13,4,77,39,500
453,Marvin Williams,PF,33,CHO,24,0,487,63,127,0.496,30,75,0.4,33,52,0.635,0.614,27,30,0.9,9,57,66,23,16,10,16,40,183
454,Robert Williams,C,22,BOS,19,1,269,33,49,0.6729999999999999,0,0,0.0,33,49,0.6729999999999999,0.6729999999999999,8,14,0.5710000000000001,23,64,87,21,17,21,16,34,74
455,Nigel Williams-Goss,PG,25,UTA,7,0,22,0,5,0.0,0,1,0.0,0,4,0.0,0.0,2,2,1.0,1,1,2,2,0,1,1,1,2
456,D.J. Wilson,PF,23,MIL,11,0,127,23,46,0.5,10,29,0.345,13,17,0.765,0.609,1,1,1.0,4,21,25,9,0,1,6,11,57
457,Justise Winslow,SF,23,MIA,10,5,337,50,127,0.39399999999999996,6,26,0.231,44,101,0.436,0.41700000000000004,18,27,0.667,16,55,71,43,6,4,23,36,124
458,Christian Wood,PF,24,DET,22,0,331,73,117,0.624,15,31,0.484,58,86,0.674,0.688,36,55,0.655,27,72,99,12,7,19,21,21,197
459,Delon Wright,SG,27,DAL,22,2,466,62,129,0.48100000000000004,13,37,0.35100000000000003,49,92,0.5329999999999999,0.531,28,34,0.8240000000000001,17,58,75,74,25,7,15,27,165
460,Thaddeus Young,PF,31,CHI,24,0,508,83,203,0.409,27,79,0.342,56,124,0.452,0.475,17,30,0.5670000000000001,38,62,100,37,22,7,38,40,210
461,Trae Young,PG,21,ATL,22,22,761,208,450,0.462,76,196,0.38799999999999996,132,254,0.52,0.547,141,164,0.86,10,80,90,185,28,1,108,29,633
462,Cody Zeller,C,27,CHO,22,17,517,101,188,0.537,13,38,0.342,88,150,0.5870000000000001,0.5720000000000001,33,51,0.647,63,105,168,27,12,10,35,53,248
463,Ante Žižić,C,23,CLE,8,0,85,13,26,0.5,0,0,0.0,13,26,0.5,0.5,5,6,0.833,7,14,21,0,2,2,1,9,31
464,Ivica Zubac,C,22,LAC,25,23,419,80,136,0.588,0,2,0.0,80,134,0.597,0.588,51,61,0.836,60,106,166,23,4,27,22,58,211
